,Entity,Code,Year,Mental_disorders_male(number),Mental_disorders_female(number),Total
0,Afghanistan,AFG,1990,817997,885788,1703785
1,Afghanistan,AFG,1991,914089,970569,1884658
2,Afghanistan,AFG,1992,1076500,1107967,2184467
3,Afghanistan,AFG,1993,1199665,1210314,2409979
4,Afghanistan,AFG,1994,1264450,1267300,2531750
5,Afghanistan,AFG,1995,1331947,1325542,2657489
6,Afghanistan,AFG,1996,1404489,1387732,2792221
7,Afghanistan,AFG,1997,1474959,1448680,2923639
8,Afghanistan,AFG,1998,1515358,1488266,3003624
9,Afghanistan,AFG,1999,1531636,1509335,3040971
10,Afghanistan,AFG,2000,1557567,1537281,3094848
11,Afghanistan,AFG,2001,1627089,1598132,3225221
12,Afghanistan,AFG,2002,1740682,1691555,3432237
13,Afghanistan,AFG,2003,1828985,1767042,3596027
14,Afghanistan,AFG,2004,1908269,1835909,3744178
15,Afghanistan,AFG,2005,1983529,1903041,3886570
16,Afghanistan,AFG,2006,2024599,1946612,3971211
17,Afghanistan,AFG,2007,2081285,2002564,4083849
18,Afghanistan,AFG,2008,2145759,2065695,4211454
19,Afghanistan,AFG,2009,2206178,2124136,4330314
20,Afghanistan,AFG,2010,2281717,2197714,4479431
21,Afghanistan,AFG,2011,2358957,2273261,4632218
22,Afghanistan,AFG,2012,2434814,2351566,4786380
23,Afghanistan,AFG,2013,2510147,2428680,4938827
24,Afghanistan,AFG,2014,2561881,2490087,5051968
25,Afghanistan,AFG,2015,2616684,2552922,5169606
26,Afghanistan,AFG,2016,2696946,2635374,5332320
27,Afghanistan,AFG,2017,2787166,2723198,5510364
28,Afghanistan,AFG,2018,2873017,2816386,5689403
29,Afghanistan,AFG,2019,2964115,2917231,5881346
30,African Region (WHO),,1990,25662030,27574871,53236901
31,African Region (WHO),,1991,26448836,28369524,54818360
32,African Region (WHO),,1992,27218829,29146311,56365140
33,African Region (WHO),,1993,28020345,29950975,57971320
34,African Region (WHO),,1994,28888717,30849564,59738281
35,African Region (WHO),,1995,29792573,31809268,61601841
36,African Region (WHO),,1996,30733982,32839895,63573877
37,African Region (WHO),,1997,31687275,33928856,65616131
38,African Region (WHO),,1998,32632666,35023510,67656176
39,African Region (WHO),,1999,33583767,36114603,69698370
40,African Region (WHO),,2000,34532335,37163861,71696196
41,African Region (WHO),,2001,35490707,38165657,73656364
42,African Region (WHO),,2002,36462525,39153428,75615953
43,African Region (WHO),,2003,37442065,40142342,77584407
44,African Region (WHO),,2004,38430255,41149954,79580209
45,African Region (WHO),,2005,39431164,42202664,81633828
46,African Region (WHO),,2006,40435578,43274562,83710140
47,African Region (WHO),,2007,41438785,44338844,85777629
48,African Region (WHO),,2008,42454313,45413736,87868049
49,African Region (WHO),,2009,43494511,46524281,90018792
50,African Region (WHO),,2010,44564600,47689755,92254355
51,African Region (WHO),,2011,45645983,48878481,94524464
52,African Region (WHO),,2012,46728084,50078759,96806843
53,African Region (WHO),,2013,47828850,51304700,99133550
54,African Region (WHO),,2014,48967255,52609445,101576700
55,African Region (WHO),,2015,50175936,54024590,104200526
56,African Region (WHO),,2016,51450624,55591303,107041927
57,African Region (WHO),,2017,52811364,57236635,110047999
58,African Region (WHO),,2018,54264948,58875279,113140227
59,African Region (WHO),,2019,55784990,60507669,116292659
60,Albania,ALB,1990,171708,178534,350242
61,Albania,ALB,1991,173235,181079,354314
62,Albania,ALB,1992,174231,183206,357437
63,Albania,ALB,1993,174764,185013,359777
64,Albania,ALB,1994,174788,186499,361287
65,Albania,ALB,1995,174280,187583,361863
66,Albania,ALB,1996,173573,188513,362086
67,Albania,ALB,1997,178915,194288,373203
68,Albania,ALB,1998,183562,199514,383076
69,Albania,ALB,1999,174214,193375,367589
70,Albania,ALB,2000,165950,187675,353625
71,Albania,ALB,2001,164226,187036,351262
72,Albania,ALB,2002,162716,186421,349137
73,Albania,ALB,2003,161283,185722,347005
74,Albania,ALB,2004,159801,184826,344627
75,Albania,ALB,2005,158273,183823,342096
76,Albania,ALB,2006,156863,182841,339704
77,Albania,ALB,2007,155556,182023,337579
78,Albania,ALB,2008,154316,181255,335571
79,Albania,ALB,2009,153035,180500,333535
80,Albania,ALB,2010,151842,179884,331726
81,Albania,ALB,2011,150895,179502,330397
82,Albania,ALB,2012,149779,179040,328819
83,Albania,ALB,2013,148208,178065,326273
84,Albania,ALB,2014,146602,177025,323627
85,Albania,ALB,2015,145749,176536,322285
86,Albania,ALB,2016,145010,175906,320916
87,Albania,ALB,2017,143817,174904,318721
88,Albania,ALB,2018,142660,174429,317089
89,Albania,ALB,2019,141723,174416,316139
90,Algeria,DZA,1990,1625207,1723057,3348264
91,Algeria,DZA,1991,1678152,1782108,3460260
92,Algeria,DZA,1992,1729820,1841173,3570993
93,Algeria,DZA,1993,1782107,1900351,3682458
94,Algeria,DZA,1994,1833533,1957679,3791212
95,Algeria,DZA,1995,1882807,2014222,3897029
96,Algeria,DZA,1996,1931800,2069376,4001176
97,Algeria,DZA,1997,1979718,2122628,4102346
98,Algeria,DZA,1998,2026458,2174584,4201042
99,Algeria,DZA,1999,2072020,2225278,4297298
100,Algeria,DZA,2000,2114296,2275765,4390061
101,Algeria,DZA,2001,2152380,2324700,4477080
102,Algeria,DZA,2002,2186486,2371007,4557493
103,Algeria,DZA,2003,2217870,2416395,4634265
104,Algeria,DZA,2004,2246755,2460476,4707231
105,Algeria,DZA,2005,2276272,2503443,4779715
106,Algeria,DZA,2006,2305429,2545315,4850744
107,Algeria,DZA,2007,2333276,2584954,4918230
108,Algeria,DZA,2008,2361059,2622418,4983477
109,Algeria,DZA,2009,2389170,2661071,5050241
110,Algeria,DZA,2010,2419711,2701359,5121070
111,Algeria,DZA,2011,2452781,2743172,5195953
112,Algeria,DZA,2012,2488101,2787633,5275734
113,Algeria,DZA,2013,2525311,2833962,5359273
114,Algeria,DZA,2014,2562998,2880384,5443382
115,Algeria,DZA,2015,2601194,2924386,5525580
116,Algeria,DZA,2016,2635257,2968591,5603848
117,Algeria,DZA,2017,2670207,3014964,5685171
118,Algeria,DZA,2018,2713377,3068105,5781482
119,Algeria,DZA,2019,2759779,3130241,5890020
120,American Samoa,ASM,1990,2376,2316,4692
121,American Samoa,ASM,1991,2457,2394,4851
122,American Samoa,ASM,1992,2534,2468,5002
123,American Samoa,ASM,1993,2606,2538,5144
124,American Samoa,ASM,1994,2670,2605,5275
125,American Samoa,ASM,1995,2729,2665,5394
126,American Samoa,ASM,1996,2780,2722,5502
127,American Samoa,ASM,1997,2823,2774,5597
128,American Samoa,ASM,1998,2858,2820,5678
129,American Samoa,ASM,1999,2885,2859,5744
130,American Samoa,ASM,2000,2905,2892,5797
131,American Samoa,ASM,2001,2917,2914,5831
132,American Samoa,ASM,2002,2923,2929,5852
133,American Samoa,ASM,2003,2923,2939,5862
134,American Samoa,ASM,2004,2920,2946,5866
135,American Samoa,ASM,2005,2915,2950,5865
136,American Samoa,ASM,2006,2911,2956,5867
137,American Samoa,ASM,2007,2905,2963,5868
138,American Samoa,ASM,2008,2899,2970,5869
139,American Samoa,ASM,2009,2896,2974,5870
140,American Samoa,ASM,2010,2891,2979,5870
141,American Samoa,ASM,2011,2893,2985,5878
142,American Samoa,ASM,2012,2894,2994,5888
143,American Samoa,ASM,2013,2897,3004,5901
144,American Samoa,ASM,2014,2900,3013,5913
145,American Samoa,ASM,2015,2899,3021,5920
146,American Samoa,ASM,2016,2890,3031,5921
147,American Samoa,ASM,2017,2882,3040,5922
148,American Samoa,ASM,2018,2884,3054,5938
149,American Samoa,ASM,2019,2891,3072,5963
150,Andorra,AND,1990,3957,4223,8180
151,Andorra,AND,1991,4297,4565,8862
152,Andorra,AND,1992,4478,4799,9277
153,Andorra,AND,1993,4732,5042,9774
154,Andorra,AND,1994,4649,5030,9679
155,Andorra,AND,1995,4575,5016,9591
156,Andorra,AND,1996,4591,5080,9671
157,Andorra,AND,1997,4643,5141,9784
158,Andorra,AND,1998,4666,5192,9858
159,Andorra,AND,1999,4649,5199,9848
160,Andorra,AND,2000,4616,5196,9812
161,Andorra,AND,2001,4628,5242,9870
162,Andorra,AND,2002,4689,5331,10020
163,Andorra,AND,2003,5051,5720,10771
164,Andorra,AND,2004,5390,6067,11457
165,Andorra,AND,2005,5527,6217,11744
166,Andorra,AND,2006,5724,6399,12123
167,Andorra,AND,2007,5862,6544,12406
168,Andorra,AND,2008,5939,6642,12581
169,Andorra,AND,2009,5900,6631,12531
170,Andorra,AND,2010,5903,6657,12560
171,Andorra,AND,2011,5410,6307,11717
172,Andorra,AND,2012,5267,6168,11435
173,Andorra,AND,2013,5252,6173,11425
174,Andorra,AND,2014,5322,6249,11571
175,Andorra,AND,2015,5405,6328,11733
176,Andorra,AND,2016,5457,6360,11817
177,Andorra,AND,2017,5598,6505,12103
178,Andorra,AND,2018,5738,6657,12395
179,Andorra,AND,2019,5870,6807,12677
180,Angola,AGO,1990,573275,585252,1158527
181,Angola,AGO,1991,592365,608266,1200631
182,Angola,AGO,1992,612176,632261,1244437
183,Angola,AGO,1993,632096,657153,1289249
184,Angola,AGO,1994,652628,683013,1335641
185,Angola,AGO,1995,674260,710197,1384457
186,Angola,AGO,1996,696708,738579,1435287
187,Angola,AGO,1997,719604,768223,1487827
188,Angola,AGO,1998,742815,798583,1541398
189,Angola,AGO,1999,766930,830593,1597523
190,Angola,AGO,2000,792441,864009,1656450
191,Angola,AGO,2001,818576,898496,1717072
192,Angola,AGO,2002,846267,933454,1779721
193,Angola,AGO,2003,874777,969274,1844051
194,Angola,AGO,2004,903936,1005946,1909882
195,Angola,AGO,2005,934255,1044379,1978634
196,Angola,AGO,2006,964910,1083496,2048406
197,Angola,AGO,2007,995737,1123214,2118951
198,Angola,AGO,2008,1027331,1162837,2190168
199,Angola,AGO,2009,1060637,1204176,2264813
200,Angola,AGO,2010,1096697,1248849,2345546
201,Angola,AGO,2011,1134718,1297202,2431920
202,Angola,AGO,2012,1174629,1347435,2522064
203,Angola,AGO,2013,1216167,1399482,2615649
204,Angola,AGO,2014,1260656,1454784,2715440
205,Angola,AGO,2015,1308751,1512265,2821016
206,Angola,AGO,2016,1360178,1571179,2931357
207,Angola,AGO,2017,1413753,1631763,3045516
208,Angola,AGO,2018,1467930,1692890,3160820
209,Angola,AGO,2019,1523473,1753020,3276493
210,Antigua and Barbuda,ATG,1990,3902,4228,8130
211,Antigua and Barbuda,ATG,1991,3939,4285,8224
212,Antigua and Barbuda,ATG,1992,3993,4364,8357
213,Antigua and Barbuda,ATG,1993,4061,4465,8526
214,Antigua and Barbuda,ATG,1994,4140,4586,8726
215,Antigua and Barbuda,ATG,1995,4232,4727,8959
216,Antigua and Barbuda,ATG,1996,4337,4885,9222
217,Antigua and Barbuda,ATG,1997,4449,5053,9502
218,Antigua and Barbuda,ATG,1998,4567,5228,9795
219,Antigua and Barbuda,ATG,1999,4687,5400,10087
220,Antigua and Barbuda,ATG,2000,4807,5564,10371
221,Antigua and Barbuda,ATG,2001,4923,5716,10639
222,Antigua and Barbuda,ATG,2002,5034,5845,10879
223,Antigua and Barbuda,ATG,2003,5140,5953,11093
224,Antigua and Barbuda,ATG,2004,5235,6049,11284
225,Antigua and Barbuda,ATG,2005,5322,6126,11448
226,Antigua and Barbuda,ATG,2006,5399,6190,11589
227,Antigua and Barbuda,ATG,2007,5466,6237,11703
228,Antigua and Barbuda,ATG,2008,5523,6273,11796
229,Antigua and Barbuda,ATG,2009,5578,6305,11883
230,Antigua and Barbuda,ATG,2010,5631,6338,11969
231,Antigua and Barbuda,ATG,2011,5683,6376,12059
232,Antigua and Barbuda,ATG,2012,5734,6422,12156
233,Antigua and Barbuda,ATG,2013,5783,6470,12253
234,Antigua and Barbuda,ATG,2014,5828,6516,12344
235,Antigua and Barbuda,ATG,2015,5866,6550,12416
236,Antigua and Barbuda,ATG,2016,5896,6574,12470
237,Antigua and Barbuda,ATG,2017,5921,6595,12516
238,Antigua and Barbuda,ATG,2018,5951,6643,12594
239,Antigua and Barbuda,ATG,2019,5985,6715,12700
240,Argentina,ARG,1990,1952435,2316806,4269241
241,Argentina,ARG,1991,1975452,2346391,4321843
242,Argentina,ARG,1992,1998351,2375265,4373616
243,Argentina,ARG,1993,2020328,2404011,4424339
244,Argentina,ARG,1994,2041724,2432257,4473981
245,Argentina,ARG,1995,2062365,2459852,4522217
246,Argentina,ARG,1996,2083860,2488387,4572247
247,Argentina,ARG,1997,2105716,2515851,4621567
248,Argentina,ARG,1998,2128372,2543143,4671515
249,Argentina,ARG,1999,2149676,2570912,4720588
250,Argentina,ARG,2000,2172547,2599833,4772380
251,Argentina,ARG,2001,2198212,2632343,4830555
252,Argentina,ARG,2002,2227409,2665834,4893243
253,Argentina,ARG,2003,2258219,2701909,4960128
254,Argentina,ARG,2004,2290290,2739215,5029505
255,Argentina,ARG,2005,2319920,2775853,5095773
256,Argentina,ARG,2006,2345459,2800656,5146115
257,Argentina,ARG,2007,2365724,2808122,5173846
258,Argentina,ARG,2008,2387480,2810365,5197845
259,Argentina,ARG,2009,2411490,2818603,5230093
260,Argentina,ARG,2010,2438755,2844224,5282979
261,Argentina,ARG,2011,2466308,2881142,5347450
262,Argentina,ARG,2012,2493137,2918605,5411742
263,Argentina,ARG,2013,2521431,2957458,5478889
264,Argentina,ARG,2014,2548869,2996660,5545529
265,Argentina,ARG,2015,2577567,3035249,5612816
266,Argentina,ARG,2016,2606236,3074164,5680400
267,Argentina,ARG,2017,2634992,3109799,5744791
268,Argentina,ARG,2018,2663956,3143159,5807115
269,Argentina,ARG,2019,2692275,3173355,5865630
270,Armenia,ARM,1990,167805,190415,358220
271,Armenia,ARM,1991,169205,191998,361203
272,Armenia,ARM,1992,170328,193562,363890
273,Armenia,ARM,1993,171159,194826,365985
274,Armenia,ARM,1994,171902,196237,368139
275,Armenia,ARM,1995,172424,197710,370134
276,Armenia,ARM,1996,172967,199179,372146
277,Armenia,ARM,1997,173481,200591,374072
278,Armenia,ARM,1998,173980,202065,376045
279,Armenia,ARM,1999,174223,203276,377499
280,Armenia,ARM,2000,174195,204274,378469
281,Armenia,ARM,2001,173746,204757,378503
282,Armenia,ARM,2002,172569,204520,377089
283,Armenia,ARM,2003,170870,203597,374467
284,Armenia,ARM,2004,169026,202431,371457
285,Armenia,ARM,2005,167194,201176,368370
286,Armenia,ARM,2006,165341,199817,365158
287,Armenia,ARM,2007,163404,198160,361564
288,Armenia,ARM,2008,161619,196476,358095
289,Armenia,ARM,2009,159901,194842,354743
290,Armenia,ARM,2010,158406,193508,351914
291,Armenia,ARM,2011,157107,192537,349644
292,Armenia,ARM,2012,156112,191701,347813
293,Armenia,ARM,2013,155438,191100,346538
294,Armenia,ARM,2014,154884,190564,345448
295,Armenia,ARM,2015,154389,190047,344436
296,Armenia,ARM,2016,153817,189555,343372
297,Armenia,ARM,2017,153403,189083,342486
298,Armenia,ARM,2018,153286,188790,342076
299,Armenia,ARM,2019,153342,188788,342130
300,Australia,AUS,1990,1464434,1535147,2999581
301,Australia,AUS,1991,1477902,1550881,3028783
302,Australia,AUS,1992,1489705,1566060,3055765
303,Australia,AUS,1993,1499993,1581872,3081865
304,Australia,AUS,1994,1509229,1597406,3106635
305,Australia,AUS,1995,1518688,1615252,3133940
306,Australia,AUS,1996,1524748,1634811,3159559
307,Australia,AUS,1997,1528028,1654902,3182930
308,Australia,AUS,1998,1531677,1676510,3208187
309,Australia,AUS,1999,1538762,1699837,3238599
310,Australia,AUS,2000,1551742,1725415,3277157
311,Australia,AUS,2001,1574127,1758377,3332504
312,Australia,AUS,2002,1605199,1800971,3406170
313,Australia,AUS,2003,1639652,1846618,3486270
314,Australia,AUS,2004,1673218,1889789,3563007
315,Australia,AUS,2005,1699762,1924189,3623951
316,Australia,AUS,2006,1721789,1948735,3670524
317,Australia,AUS,2007,1745221,1969969,3715190
318,Australia,AUS,2008,1769673,1990101,3759774
319,Australia,AUS,2009,1793937,2010131,3804068
320,Australia,AUS,2010,1818324,2033015,3851339
321,Australia,AUS,2011,1839977,2058575,3898552
322,Australia,AUS,2012,1859182,2086885,3946067
323,Australia,AUS,2013,1877101,2116890,3993991
324,Australia,AUS,2014,1895750,2146460,4042210
325,Australia,AUS,2015,1918858,2174362,4093220
326,Australia,AUS,2016,1962292,2189531,4151823
327,Australia,AUS,2017,2006603,2206775,4213378
328,Australia,AUS,2018,2033792,2237184,4270976
329,Australia,AUS,2019,2062183,2270452,4332635
330,Austria,AUT,1990,517169,676488,1193657
331,Austria,AUT,1991,519035,679015,1198050
332,Austria,AUT,1992,520438,680855,1201293
333,Austria,AUT,1993,521798,682590,1204388
334,Austria,AUT,1994,523041,683674,1206715
335,Austria,AUT,1995,524459,684415,1208874
336,Austria,AUT,1996,525811,684910,1210721
337,Austria,AUT,1997,527184,684496,1211680
338,Austria,AUT,1998,528524,683842,1212366
339,Austria,AUT,1999,530107,683598,1213705
340,Austria,AUT,2000,531910,684644,1216554
341,Austria,AUT,2001,534160,687080,1221240
342,Austria,AUT,2002,536559,690547,1227106
343,Austria,AUT,2003,539143,694494,1233637
344,Austria,AUT,2004,541735,698735,1240470
345,Austria,AUT,2005,544461,702262,1246723
346,Austria,AUT,2006,546930,704472,1251402
347,Austria,AUT,2007,549235,705747,1254982
348,Austria,AUT,2008,551039,706378,1257417
349,Austria,AUT,2009,552576,706631,1259207
350,Austria,AUT,2010,553734,707761,1261495
351,Austria,AUT,2011,555235,710565,1265800
352,Austria,AUT,2012,557600,714990,1272590
353,Austria,AUT,2013,561068,721089,1282157
354,Austria,AUT,2014,565970,727374,1293344
355,Austria,AUT,2015,571993,733555,1305548
356,Austria,AUT,2016,578615,739039,1317654
357,Austria,AUT,2017,583736,743737,1327473
358,Austria,AUT,2018,587821,748106,1335927
359,Austria,AUT,2019,591551,752581,1344132
360,Azerbaijan,AZE,1990,334486,369107,703593
361,Azerbaijan,AZE,1991,340154,375126,715280
362,Azerbaijan,AZE,1992,346140,381142,727282
363,Azerbaijan,AZE,1993,352444,387419,739863
364,Azerbaijan,AZE,1994,359338,393939,753277
365,Azerbaijan,AZE,1995,366842,400908,767750
366,Azerbaijan,AZE,1996,375867,408824,784691
367,Azerbaijan,AZE,1997,385990,417554,803544
368,Azerbaijan,AZE,1998,396434,426372,822806
369,Azerbaijan,AZE,1999,406357,434816,841173
370,Azerbaijan,AZE,2000,414607,442018,856625
371,Azerbaijan,AZE,2001,421584,448830,870414
372,Azerbaijan,AZE,2002,427866,455034,882900
373,Azerbaijan,AZE,2003,433446,461231,894677
374,Azerbaijan,AZE,2004,438555,467126,905681
375,Azerbaijan,AZE,2005,443162,472678,915840
376,Azerbaijan,AZE,2006,446379,477202,923581
377,Azerbaijan,AZE,2007,448209,480246,928455
378,Azerbaijan,AZE,2008,449350,482853,932203
379,Azerbaijan,AZE,2009,450821,485931,936752
380,Azerbaijan,AZE,2010,453548,490276,943824
381,Azerbaijan,AZE,2011,457170,496185,953355
382,Azerbaijan,AZE,2012,461339,502103,963442
383,Azerbaijan,AZE,2013,465667,508306,973973
384,Azerbaijan,AZE,2014,470621,514968,985589
385,Azerbaijan,AZE,2015,475733,521059,996792
386,Azerbaijan,AZE,2016,480827,526591,1007418
387,Azerbaijan,AZE,2017,486427,531920,1018347
388,Azerbaijan,AZE,2018,492215,539055,1031270
389,Azerbaijan,AZE,2019,498507,547649,1046156
390,Bahamas,BHS,1990,17190,17679,34869
391,Bahamas,BHS,1991,17491,17957,35448
392,Bahamas,BHS,1992,17784,18254,36038
393,Bahamas,BHS,1993,18087,18573,36660
394,Bahamas,BHS,1994,18387,18912,37299
395,Bahamas,BHS,1995,18698,19299,37997
396,Bahamas,BHS,1996,19019,19716,38735
397,Bahamas,BHS,1997,19359,20154,39513
398,Bahamas,BHS,1998,19720,20617,40337
399,Bahamas,BHS,1999,20054,21077,41131
400,Bahamas,BHS,2000,20384,21518,41902
401,Bahamas,BHS,2001,20720,21941,42661
402,Bahamas,BHS,2002,21070,22361,43431
403,Bahamas,BHS,2003,21426,22778,44204
404,Bahamas,BHS,2004,21760,23172,44932
405,Bahamas,BHS,2005,22066,23537,45603
406,Bahamas,BHS,2006,22366,23893,46259
407,Bahamas,BHS,2007,22656,24247,46903
408,Bahamas,BHS,2008,22939,24608,47547
409,Bahamas,BHS,2009,23225,24957,48182
410,Bahamas,BHS,2010,23491,25297,48788
411,Bahamas,BHS,2011,23760,25646,49406
412,Bahamas,BHS,2012,24025,26030,50055
413,Bahamas,BHS,2013,24289,26428,50717
414,Bahamas,BHS,2014,24548,26818,51366
415,Bahamas,BHS,2015,24780,27161,51941
416,Bahamas,BHS,2016,24946,27472,52418
417,Bahamas,BHS,2017,25083,27766,52849
418,Bahamas,BHS,2018,25245,28132,53377
419,Bahamas,BHS,2019,25413,28574,53987
420,Bahrain,BHR,1990,41171,32248,73419
421,Bahrain,BHR,1991,42566,33548,76114
422,Bahrain,BHR,1992,43711,34707,78418
423,Bahrain,BHR,1993,44729,35792,80521
424,Bahrain,BHR,1994,45684,36847,82531
425,Bahrain,BHR,1995,46614,37912,84526
426,Bahrain,BHR,1996,47595,38990,86585
427,Bahrain,BHR,1997,48767,40104,88871
428,Bahrain,BHR,1998,50073,41229,91302
429,Bahrain,BHR,1999,51547,42417,93964
430,Bahrain,BHR,2000,53217,43739,96956
431,Bahrain,BHR,2001,55321,45330,100651
432,Bahrain,BHR,2002,58755,47729,106484
433,Bahrain,BHR,2003,64029,51004,115033
434,Bahrain,BHR,2004,70669,54793,125462
435,Bahrain,BHR,2005,77392,58502,135894
436,Bahrain,BHR,2006,83802,61975,145777
437,Bahrain,BHR,2007,90677,65586,156263
438,Bahrain,BHR,2008,98770,69582,168352
439,Bahrain,BHR,2009,107156,73602,180758
440,Bahrain,BHR,2010,114097,76981,191078
441,Bahrain,BHR,2011,118130,79207,197337
442,Bahrain,BHR,2012,121178,81097,202275
443,Bahrain,BHR,2013,124169,82974,207143
444,Bahrain,BHR,2014,126761,84758,211519
445,Bahrain,BHR,2015,128441,86210,214651
446,Bahrain,BHR,2016,129001,87347,216348
447,Bahrain,BHR,2017,129530,88435,217965
448,Bahrain,BHR,2018,130317,89669,219986
449,Bahrain,BHR,2019,131180,90989,222169
450,Bangladesh,BGD,1990,6592090,6023810,12615900
451,Bangladesh,BGD,1991,6706571,6111561,12818132
452,Bangladesh,BGD,1992,6807726,6197747,13005473
453,Bangladesh,BGD,1993,6912252,6284059,13196311
454,Bangladesh,BGD,1994,7007850,6371263,13379113
455,Bangladesh,BGD,1995,7096657,6467669,13564326
456,Bangladesh,BGD,1996,7181480,6565671,13747151
457,Bangladesh,BGD,1997,7252470,6667968,13920438
458,Bangladesh,BGD,1998,7317240,6773165,14090405
459,Bangladesh,BGD,1999,7378086,6877561,14255647
460,Bangladesh,BGD,2000,7441245,6981396,14422641
461,Bangladesh,BGD,2001,7525738,7099686,14625424
462,Bangladesh,BGD,2002,7638960,7236364,14875324
463,Bangladesh,BGD,2003,7763664,7384411,15148075
464,Bangladesh,BGD,2004,7873495,7532921,15406416
465,Bangladesh,BGD,2005,7952167,7667940,15620107
466,Bangladesh,BGD,2006,7973450,7782788,15756238
467,Bangladesh,BGD,2007,7961093,7894370,15855463
468,Bangladesh,BGD,2008,7935348,8004071,15939419
469,Bangladesh,BGD,2009,7925097,8123684,16048781
470,Bangladesh,BGD,2010,7947632,8260772,16208404
471,Bangladesh,BGD,2011,7999280,8412540,16411820
472,Bangladesh,BGD,2012,8065984,8565681,16631665
473,Bangladesh,BGD,2013,8133077,8722421,16855498
474,Bangladesh,BGD,2014,8204163,8888944,17093107
475,Bangladesh,BGD,2015,8274100,9051460,17325560
476,Bangladesh,BGD,2016,8342942,9221418,17564360
477,Bangladesh,BGD,2017,8416085,9387095,17803180
478,Bangladesh,BGD,2018,8498373,9552060,18050433
479,Bangladesh,BGD,2019,8596502,9712123,18308625
480,Barbados,BRB,1990,16889,18460,35349
481,Barbados,BRB,1991,16863,18417,35280
482,Barbados,BRB,1992,16832,18379,35211
483,Barbados,BRB,1993,16811,18359,35170
484,Barbados,BRB,1994,16789,18360,35149
485,Barbados,BRB,1995,16776,18389,35165
486,Barbados,BRB,1996,16773,18440,35213
487,Barbados,BRB,1997,16790,18519,35309
488,Barbados,BRB,1998,16813,18615,35428
489,Barbados,BRB,1999,16863,18734,35597
490,Barbados,BRB,2000,16946,18865,35811
491,Barbados,BRB,2001,17056,19031,36087
492,Barbados,BRB,2002,17196,19212,36408
493,Barbados,BRB,2003,17357,19399,36756
494,Barbados,BRB,2004,17521,19610,37131
495,Barbados,BRB,2005,17697,19827,37524
496,Barbados,BRB,2006,17881,20048,37929
497,Barbados,BRB,2007,18076,20284,38360
498,Barbados,BRB,2008,18278,20502,38780
499,Barbados,BRB,2009,18481,20739,39220
500,Barbados,BRB,2010,18685,20969,39654
501,Barbados,BRB,2011,18884,21217,40101
502,Barbados,BRB,2012,19083,21479,40562
503,Barbados,BRB,2013,19265,21740,41005
504,Barbados,BRB,2014,19433,21979,41412
505,Barbados,BRB,2015,19588,22193,41781
506,Barbados,BRB,2016,19704,22376,42080
507,Barbados,BRB,2017,19798,22534,42332
508,Barbados,BRB,2018,19914,22722,42636
509,Barbados,BRB,2019,20031,22946,42977
510,Belarus,BLR,1990,576510,739347,1315857
511,Belarus,BLR,1991,581888,743889,1325777
512,Belarus,BLR,1992,586780,748299,1335079
513,Belarus,BLR,1993,591201,752168,1343369
514,Belarus,BLR,1994,594748,755387,1350135
515,Belarus,BLR,1995,597927,757943,1355870
516,Belarus,BLR,1996,600904,760464,1361368
517,Belarus,BLR,1997,603869,763258,1367127
518,Belarus,BLR,1998,606090,765496,1371586
519,Belarus,BLR,1999,606877,766628,1373505
520,Belarus,BLR,2000,605938,766659,1372597
521,Belarus,BLR,2001,603246,765299,1368545
522,Belarus,BLR,2002,598983,762862,1361845
523,Belarus,BLR,2003,593511,759327,1352838
524,Belarus,BLR,2004,587899,755523,1343422
525,Belarus,BLR,2005,581584,751444,1333028
526,Belarus,BLR,2006,574746,746099,1320845
527,Belarus,BLR,2007,567217,739932,1307149
528,Belarus,BLR,2008,559317,733433,1292750
529,Belarus,BLR,2009,552073,727447,1279520
530,Belarus,BLR,2010,545880,722598,1268478
531,Belarus,BLR,2011,540448,718288,1258736
532,Belarus,BLR,2012,535516,714645,1250161
533,Belarus,BLR,2013,531629,711379,1243008
534,Belarus,BLR,2014,528703,708747,1237450
535,Belarus,BLR,2015,526560,706243,1232803
536,Belarus,BLR,2016,525108,704294,1229402
537,Belarus,BLR,2017,523844,702310,1226154
538,Belarus,BLR,2018,521875,698814,1220689
539,Belarus,BLR,2019,519376,693909,1213285
540,Belgium,BEL,1990,651332,752420,1403752
541,Belgium,BEL,1991,652566,752727,1405293
542,Belgium,BEL,1992,653845,753013,1406858
543,Belgium,BEL,1993,654953,753515,1408468
544,Belgium,BEL,1994,655935,754118,1410053
545,Belgium,BEL,1995,657324,754874,1412198
546,Belgium,BEL,1996,659089,754757,1413846
547,Belgium,BEL,1997,660697,753407,1414104
548,Belgium,BEL,1998,662558,751544,1414102
549,Belgium,BEL,1999,664433,751070,1415503
550,Belgium,BEL,2000,667100,753089,1420189
551,Belgium,BEL,2001,670335,757169,1427504
552,Belgium,BEL,2002,674092,762129,1436221
553,Belgium,BEL,2003,677902,766992,1444894
554,Belgium,BEL,2004,681906,772634,1454540
555,Belgium,BEL,2005,686294,778653,1464947
556,Belgium,BEL,2006,691804,788089,1479893
557,Belgium,BEL,2007,698149,801828,1499977
558,Belgium,BEL,2008,705043,816642,1521685
559,Belgium,BEL,2009,711581,830160,1541741
560,Belgium,BEL,2010,717222,839280,1556502
561,Belgium,BEL,2011,722543,844893,1567436
562,Belgium,BEL,2012,727329,849390,1576719
563,Belgium,BEL,2013,731868,853014,1584882
564,Belgium,BEL,2014,736393,856141,1592534
565,Belgium,BEL,2015,740789,859119,1599908
566,Belgium,BEL,2016,745455,861509,1606964
567,Belgium,BEL,2017,750234,863288,1613522
568,Belgium,BEL,2018,753476,865527,1619003
569,Belgium,BEL,2019,755600,867514,1623114
570,Belize,BLZ,1990,12629,11171,23800
571,Belize,BLZ,1991,12952,11457,24409
572,Belize,BLZ,1992,13282,11761,25043
573,Belize,BLZ,1993,13631,12091,25722
574,Belize,BLZ,1994,13999,12445,26444
575,Belize,BLZ,1995,14379,12821,27200
576,Belize,BLZ,1996,14782,13228,28010
577,Belize,BLZ,1997,15204,13658,28862
578,Belize,BLZ,1998,15645,14123,29768
579,Belize,BLZ,1999,16098,14604,30702
580,Belize,BLZ,2000,16575,15107,31682
581,Belize,BLZ,2001,17081,15635,32716
582,Belize,BLZ,2002,17618,16185,33803
583,Belize,BLZ,2003,18188,16767,34955
584,Belize,BLZ,2004,18786,17372,36158
585,Belize,BLZ,2005,19416,18006,37422
586,Belize,BLZ,2006,20078,18664,38742
587,Belize,BLZ,2007,20755,19353,40108
588,Belize,BLZ,2008,21436,20051,41487
589,Belize,BLZ,2009,22135,20786,42921
590,Belize,BLZ,2010,22854,21525,44379
591,Belize,BLZ,2011,23572,22284,45856
592,Belize,BLZ,2012,24295,23059,47354
593,Belize,BLZ,2013,25012,23849,48861
594,Belize,BLZ,2014,25721,24630,50351
595,Belize,BLZ,2015,26402,25407,51809
596,Belize,BLZ,2016,27077,26174,53251
597,Belize,BLZ,2017,27724,26943,54667
598,Belize,BLZ,2018,28350,27701,56051
599,Belize,BLZ,2019,28957,28472,57429
600,Benin,BEN,1990,217446,243278,460724
601,Benin,BEN,1991,225773,251762,477535
602,Benin,BEN,1992,234326,260535,494861
603,Benin,BEN,1993,242913,269606,512519
604,Benin,BEN,1994,251532,278936,530468
605,Benin,BEN,1995,260340,288657,548997
606,Benin,BEN,1996,269396,298537,567933
607,Benin,BEN,1997,278746,308777,587523
608,Benin,BEN,1998,288152,319334,607486
609,Benin,BEN,1999,297879,330175,628054
610,Benin,BEN,2000,307969,341330,649299
611,Benin,BEN,2001,318383,352921,671304
612,Benin,BEN,2002,329094,364576,693670
613,Benin,BEN,2003,340459,376764,717223
614,Benin,BEN,2004,352411,389439,741850
615,Benin,BEN,2005,365055,402467,767522
616,Benin,BEN,2006,378158,416052,794210
617,Benin,BEN,2007,391858,429949,821807
618,Benin,BEN,2008,406323,444555,850878
619,Benin,BEN,2009,421307,459657,880964
620,Benin,BEN,2010,437161,475640,912801
621,Benin,BEN,2011,453264,492090,945354
622,Benin,BEN,2012,470056,509212,979268
623,Benin,BEN,2013,487218,527241,1014459
624,Benin,BEN,2014,505211,545584,1050795
625,Benin,BEN,2015,523326,564256,1087582
626,Benin,BEN,2016,541734,583844,1125578
627,Benin,BEN,2017,560933,603673,1164606
628,Benin,BEN,2018,581089,624311,1205400
629,Benin,BEN,2019,602335,645608,1247943
630,Bermuda,BMU,1990,4104,4608,8712
631,Bermuda,BMU,1991,4121,4637,8758
632,Bermuda,BMU,1992,4138,4668,8806
633,Bermuda,BMU,1993,4156,4698,8854
634,Bermuda,BMU,1994,4172,4729,8901
635,Bermuda,BMU,1995,4189,4761,8950
636,Bermuda,BMU,1996,4204,4795,8999
637,Bermuda,BMU,1997,4218,4831,9049
638,Bermuda,BMU,1998,4231,4865,9096
639,Bermuda,BMU,1999,4245,4898,9143
640,Bermuda,BMU,2000,4260,4928,9188
641,Bermuda,BMU,2001,4276,4952,9228
642,Bermuda,BMU,2002,4293,4974,9267
643,Bermuda,BMU,2003,4309,4990,9299
644,Bermuda,BMU,2004,4322,5005,9327
645,Bermuda,BMU,2005,4333,5018,9351
646,Bermuda,BMU,2006,4338,5032,9370
647,Bermuda,BMU,2007,4341,5042,9383
648,Bermuda,BMU,2008,4339,5048,9387
649,Bermuda,BMU,2009,4337,5056,9393
650,Bermuda,BMU,2010,4338,5061,9399
651,Bermuda,BMU,2011,4340,5065,9405
652,Bermuda,BMU,2012,4342,5067,9409
653,Bermuda,BMU,2013,4343,5064,9407
654,Bermuda,BMU,2014,4341,5059,9400
655,Bermuda,BMU,2015,4334,5049,9383
656,Bermuda,BMU,2016,4319,5037,9356
657,Bermuda,BMU,2017,4301,5024,9325
658,Bermuda,BMU,2018,4287,5014,9301
659,Bermuda,BMU,2019,4271,5006,9277
660,Bhutan,BTN,1990,37056,32098,69154
661,Bhutan,BTN,1991,35487,31192,66679
662,Bhutan,BTN,1992,34605,30667,65272
663,Bhutan,BTN,1993,34659,30740,65399
664,Bhutan,BTN,1994,35097,31057,66154
665,Bhutan,BTN,1995,35748,31526,67274
666,Bhutan,BTN,1996,36447,32039,68486
667,Bhutan,BTN,1997,37206,32623,69829
668,Bhutan,BTN,1998,37837,33130,70967
669,Bhutan,BTN,1999,38337,33575,71912
670,Bhutan,BTN,2000,38793,33971,72764
671,Bhutan,BTN,2001,39152,34331,73483
672,Bhutan,BTN,2002,39480,34642,74122
673,Bhutan,BTN,2003,39727,34917,74644
674,Bhutan,BTN,2004,39905,35145,75050
675,Bhutan,BTN,2005,40145,35436,75581
676,Bhutan,BTN,2006,40568,35841,76409
677,Bhutan,BTN,2007,41195,36380,77575
678,Bhutan,BTN,2008,42028,37060,79088
679,Bhutan,BTN,2009,42952,37828,80780
680,Bhutan,BTN,2010,43892,38663,82555
681,Bhutan,BTN,2011,44765,39504,84269
682,Bhutan,BTN,2012,45368,40198,85566
683,Bhutan,BTN,2013,45730,40782,86512
684,Bhutan,BTN,2014,45957,41302,87259
685,Bhutan,BTN,2015,46092,41753,87845
686,Bhutan,BTN,2016,46049,42083,88132
687,Bhutan,BTN,2017,45855,42340,88195
688,Bhutan,BTN,2018,45720,42691,88411
689,Bhutan,BTN,2019,45688,43147,88835
690,Bolivia,BOL,1990,405639,454100,859739
691,Bolivia,BOL,1991,416351,465807,882158
692,Bolivia,BOL,1992,427636,478260,905896
693,Bolivia,BOL,1993,439818,491516,931334
694,Bolivia,BOL,1994,452906,505703,958609
695,Bolivia,BOL,1995,466644,520372,987016
696,Bolivia,BOL,1996,480847,535670,1016517
697,Bolivia,BOL,1997,495371,551431,1046802
698,Bolivia,BOL,1998,510054,567417,1077471
699,Bolivia,BOL,1999,524816,583626,1108442
700,Bolivia,BOL,2000,539995,600105,1140100
701,Bolivia,BOL,2001,554927,616392,1171319
702,Bolivia,BOL,2002,569733,632336,1202069
703,Bolivia,BOL,2003,583875,647919,1231794
704,Bolivia,BOL,2004,597654,663267,1260921
705,Bolivia,BOL,2005,611155,678493,1289648
706,Bolivia,BOL,2006,624022,693846,1317868
707,Bolivia,BOL,2007,636572,708958,1345530
708,Bolivia,BOL,2008,648650,723520,1372170
709,Bolivia,BOL,2009,660289,738662,1398951
710,Bolivia,BOL,2010,672120,753595,1425715
711,Bolivia,BOL,2011,683599,769172,1452771
712,Bolivia,BOL,2012,695684,784602,1480286
713,Bolivia,BOL,2013,707680,800537,1508217
714,Bolivia,BOL,2014,720235,815779,1536014
715,Bolivia,BOL,2015,732624,831037,1563661
716,Bolivia,BOL,2016,744929,845605,1590534
717,Bolivia,BOL,2017,757644,860341,1617985
718,Bolivia,BOL,2018,770493,875684,1646177
719,Bolivia,BOL,2019,783984,891323,1675307
720,Bosnia and Herzegovina,BIH,1990,256671,298388,555059
721,Bosnia and Herzegovina,BIH,1991,256486,299098,555584
722,Bosnia and Herzegovina,BIH,1992,248157,293524,541681
723,Bosnia and Herzegovina,BIH,1993,238899,287262,526161
724,Bosnia and Herzegovina,BIH,1994,228900,280042,508942
725,Bosnia and Herzegovina,BIH,1995,217511,271582,489093
726,Bosnia and Herzegovina,BIH,1996,216149,271139,487288
727,Bosnia and Herzegovina,BIH,1997,223474,277456,500930
728,Bosnia and Herzegovina,BIH,1998,228665,282220,510885
729,Bosnia and Herzegovina,BIH,1999,228044,282412,510456
730,Bosnia and Herzegovina,BIH,2000,224844,280400,505244
731,Bosnia and Herzegovina,BIH,2001,222937,278998,501935
732,Bosnia and Herzegovina,BIH,2002,223402,278928,502330
733,Bosnia and Herzegovina,BIH,2003,224693,279033,503726
734,Bosnia and Herzegovina,BIH,2004,222608,276516,499124
735,Bosnia and Herzegovina,BIH,2005,217860,272082,489942
736,Bosnia and Herzegovina,BIH,2006,215096,269117,484213
737,Bosnia and Herzegovina,BIH,2007,212120,265909,478029
738,Bosnia and Herzegovina,BIH,2008,207200,261135,468335
739,Bosnia and Herzegovina,BIH,2009,202329,256322,458651
740,Bosnia and Herzegovina,BIH,2010,197921,251920,449841
741,Bosnia and Herzegovina,BIH,2011,194134,248201,442335
742,Bosnia and Herzegovina,BIH,2012,190846,244825,435671
743,Bosnia and Herzegovina,BIH,2013,187572,241383,428955
744,Bosnia and Herzegovina,BIH,2014,184066,237993,422059
745,Bosnia and Herzegovina,BIH,2015,180800,234757,415557
746,Bosnia and Herzegovina,BIH,2016,177638,231629,409267
747,Bosnia and Herzegovina,BIH,2017,174687,228729,403416
748,Bosnia and Herzegovina,BIH,2018,171945,226390,398335
749,Bosnia and Herzegovina,BIH,2019,169462,224529,393991
750,Botswana,BWA,1990,59201,67753,126954
751,Botswana,BWA,1991,61687,70397,132084
752,Botswana,BWA,1992,64195,73020,137215
753,Botswana,BWA,1993,66669,75679,142348
754,Botswana,BWA,1994,69105,78325,147430
755,Botswana,BWA,1995,71480,80879,152359
756,Botswana,BWA,1996,73771,83465,157236
757,Botswana,BWA,1997,75964,85972,161936
758,Botswana,BWA,1998,78050,88437,166487
759,Botswana,BWA,1999,79985,90717,170702
760,Botswana,BWA,2000,81796,92817,174613
761,Botswana,BWA,2001,83520,94732,178252
762,Botswana,BWA,2002,85178,96563,181741
763,Botswana,BWA,2003,86811,98363,185174
764,Botswana,BWA,2004,88533,100246,188779
765,Botswana,BWA,2005,90408,102255,192663
766,Botswana,BWA,2006,92437,104351,196788
767,Botswana,BWA,2007,94509,106429,200938
768,Botswana,BWA,2008,96653,108498,205151
769,Botswana,BWA,2009,98852,110712,209564
770,Botswana,BWA,2010,101122,113084,214206
771,Botswana,BWA,2011,103439,115635,219074
772,Botswana,BWA,2012,105828,118318,224146
773,Botswana,BWA,2013,108315,121078,229393
774,Botswana,BWA,2014,110788,123839,234627
775,Botswana,BWA,2015,113224,126612,239836
776,Botswana,BWA,2016,115727,129531,245258
777,Botswana,BWA,2017,118261,132380,250641
778,Botswana,BWA,2018,120759,134984,255743
779,Botswana,BWA,2019,123209,137355,260564
780,Brazil,BRA,1990,9644006,11745908,21389914
781,Brazil,BRA,1991,9823292,12027953,21851245
782,Brazil,BRA,1992,10012715,12329648,22342363
783,Brazil,BRA,1993,10209328,12639647,22848975
784,Brazil,BRA,1994,10409353,12949927,23359280
785,Brazil,BRA,1995,10611888,13257983,23869871
786,Brazil,BRA,1996,10881889,13683943,24565832
787,Brazil,BRA,1997,11247731,14306779,25554510
788,Brazil,BRA,1998,11659681,15041653,26701334
789,Brazil,BRA,1999,12062595,15795402,27857997
790,Brazil,BRA,2000,12388112,16476451,28864563
791,Brazil,BRA,2001,12656350,17137437,29793787
792,Brazil,BRA,2002,12925637,17852170,30777807
793,Brazil,BRA,2003,13182649,18557741,31740390
794,Brazil,BRA,2004,13422084,19182590,32604674
795,Brazil,BRA,2005,13633383,19651650,33285033
796,Brazil,BRA,2006,13783926,19944350,33728276
797,Brazil,BRA,2007,13866408,20125562,33991970
798,Brazil,BRA,2008,13918122,20252478,34170600
799,Brazil,BRA,2009,13976297,20383740,34360037
800,Brazil,BRA,2010,14082333,20585807,34668140
801,Brazil,BRA,2011,14210828,20676644,34887472
802,Brazil,BRA,2012,14316386,20522909,34839295
803,Brazil,BRA,2013,14413544,20271826,34685370
804,Brazil,BRA,2014,14520861,20081614,34602475
805,Brazil,BRA,2015,14658078,20127849,34785927
806,Brazil,BRA,2016,14835534,20370130,35205664
807,Brazil,BRA,2017,15006668,20619696,35626364
808,Brazil,BRA,2018,15155997,20868149,36024146
809,Brazil,BRA,2019,15295628,21117808,36413436
810,Brunei,BRN,1990,13667,10871,24538
811,Brunei,BRN,1991,14036,11224,25260
812,Brunei,BRN,1992,14397,11600,25997
813,Brunei,BRN,1993,14766,11986,26752
814,Brunei,BRN,1994,15120,12394,27514
815,Brunei,BRN,1995,15472,12822,28294
816,Brunei,BRN,1996,15814,13268,29082
817,Brunei,BRN,1997,16157,13718,29875
818,Brunei,BRN,1998,16503,14176,30679
819,Brunei,BRN,1999,16839,14627,31466
820,Brunei,BRN,2000,17194,15060,32254
821,Brunei,BRN,2001,17560,15476,33036
822,Brunei,BRN,2002,17948,15860,33808
823,Brunei,BRN,2003,18331,16229,34560
824,Brunei,BRN,2004,18719,16571,35290
825,Brunei,BRN,2005,19107,16904,36011
826,Brunei,BRN,2006,19470,17217,36687
827,Brunei,BRN,2007,19814,17498,37312
828,Brunei,BRN,2008,20145,17762,37907
829,Brunei,BRN,2009,20492,18019,38511
830,Brunei,BRN,2010,20847,18285,39132
831,Brunei,BRN,2011,21215,18551,39766
832,Brunei,BRN,2012,21585,18815,40400
833,Brunei,BRN,2013,21937,19077,41014
834,Brunei,BRN,2014,22274,19326,41600
835,Brunei,BRN,2015,22580,19553,42133
836,Brunei,BRN,2016,22878,19738,42616
837,Brunei,BRN,2017,23141,19913,43054
838,Brunei,BRN,2018,23410,20141,43551
839,Brunei,BRN,2019,23672,20433,44105
840,Bulgaria,BGR,1990,448102,568025,1016127
841,Bulgaria,BGR,1991,445111,566448,1011559
842,Bulgaria,BGR,1992,442050,564592,1006642
843,Bulgaria,BGR,1993,439086,562659,1001745
844,Bulgaria,BGR,1994,435886,560569,996455
845,Bulgaria,BGR,1995,432654,558311,990965
846,Bulgaria,BGR,1996,428908,555559,984467
847,Bulgaria,BGR,1997,424537,551754,976291
848,Bulgaria,BGR,1998,420047,548129,968176
849,Bulgaria,BGR,1999,415977,544810,960787
850,Bulgaria,BGR,2000,412410,541662,954072
851,Bulgaria,BGR,2001,408804,538564,947368
852,Bulgaria,BGR,2002,405070,534921,939991
853,Bulgaria,BGR,2003,401042,531433,932475
854,Bulgaria,BGR,2004,397200,527808,925008
855,Bulgaria,BGR,2005,393232,524235,917467
856,Bulgaria,BGR,2006,389450,520147,909597
857,Bulgaria,BGR,2007,385784,515576,901360
858,Bulgaria,BGR,2008,382044,510499,892543
859,Bulgaria,BGR,2009,378213,504688,882901
860,Bulgaria,BGR,2010,374151,498331,872482
861,Bulgaria,BGR,2011,369903,491558,861461
862,Bulgaria,BGR,2012,366074,485478,851552
863,Bulgaria,BGR,2013,362670,480685,843355
864,Bulgaria,BGR,2014,359646,476764,836410
865,Bulgaria,BGR,2015,356614,473046,829660
866,Bulgaria,BGR,2016,354050,469897,823947
867,Bulgaria,BGR,2017,351345,466980,818325
868,Bulgaria,BGR,2018,348407,464122,812529
869,Bulgaria,BGR,2019,345319,461213,806532
870,Burkina Faso,BFA,1990,448542,488369,936911
871,Burkina Faso,BFA,1991,458540,496533,955073
872,Burkina Faso,BFA,1992,468787,505297,974084
873,Burkina Faso,BFA,1993,479691,514490,994181
874,Burkina Faso,BFA,1994,491530,524604,1016134
875,Burkina Faso,BFA,1995,503664,536432,1040096
876,Burkina Faso,BFA,1996,516512,549484,1065996
877,Burkina Faso,BFA,1997,530092,563915,1094007
878,Burkina Faso,BFA,1998,544457,579592,1124049
879,Burkina Faso,BFA,1999,559885,596194,1156079
880,Burkina Faso,BFA,2000,576332,614170,1190502
881,Burkina Faso,BFA,2001,593469,633179,1226648
882,Burkina Faso,BFA,2002,612218,653776,1265994
883,Burkina Faso,BFA,2003,631827,675869,1307696
884,Burkina Faso,BFA,2004,652780,698888,1351668
885,Burkina Faso,BFA,2005,674592,722647,1397239
886,Burkina Faso,BFA,2006,697556,747355,1444911
887,Burkina Faso,BFA,2007,722120,774008,1496128
888,Burkina Faso,BFA,2008,748331,801130,1549461
889,Burkina Faso,BFA,2009,774952,829495,1604447
890,Burkina Faso,BFA,2010,801966,858010,1659976
891,Burkina Faso,BFA,2011,829952,888849,1718801
892,Burkina Faso,BFA,2012,859312,923270,1782582
893,Burkina Faso,BFA,2013,889996,959234,1849230
894,Burkina Faso,BFA,2014,920458,995242,1915700
895,Burkina Faso,BFA,2015,951774,1030176,1981950
896,Burkina Faso,BFA,2016,982213,1064844,2047057
897,Burkina Faso,BFA,2017,1013261,1100011,2113272
898,Burkina Faso,BFA,2018,1043436,1129221,2172657
899,Burkina Faso,BFA,2019,1070415,1151044,2221459
900,Burundi,BDI,1990,287566,323139,610705
901,Burundi,BDI,1991,284895,321133,606028
902,Burundi,BDI,1992,282140,318957,601097
903,Burundi,BDI,1993,295971,330619,626590
904,Burundi,BDI,1994,305997,339160,645157
905,Burundi,BDI,1995,301481,336141,637622
906,Burundi,BDI,1996,301352,336543,637895
907,Burundi,BDI,1997,309196,343832,653028
908,Burundi,BDI,1998,318400,352183,670583
909,Burundi,BDI,1999,325962,359441,685403
910,Burundi,BDI,2000,333937,366977,700914
911,Burundi,BDI,2001,342921,374967,717888
912,Burundi,BDI,2002,354091,384645,738736
913,Burundi,BDI,2003,367802,396470,764272
914,Burundi,BDI,2004,381957,409087,791044
915,Burundi,BDI,2005,396222,422000,818222
916,Burundi,BDI,2006,410949,435606,846555
917,Burundi,BDI,2007,429734,452517,882251
918,Burundi,BDI,2008,452721,473158,925879
919,Burundi,BDI,2009,470476,489431,959907
920,Burundi,BDI,2010,481459,500984,982443
921,Burundi,BDI,2011,495748,515140,1010888
922,Burundi,BDI,2012,514154,532749,1046903
923,Burundi,BDI,2013,529245,547846,1077091
924,Burundi,BDI,2014,539106,559232,1098338
925,Burundi,BDI,2015,550464,571925,1122389
926,Burundi,BDI,2016,570031,592218,1162249
927,Burundi,BDI,2017,596580,618491,1215071
928,Burundi,BDI,2018,623038,644015,1267053
929,Burundi,BDI,2019,648356,667547,1315903
930,Cambodia,KHM,1990,540090,688792,1228882
931,Cambodia,KHM,1991,555974,705590,1261564
932,Cambodia,KHM,1992,572115,723172,1295287
933,Cambodia,KHM,1993,587337,739522,1326859
934,Cambodia,KHM,1994,601308,754702,1356010
935,Cambodia,KHM,1995,615114,770177,1385291
936,Cambodia,KHM,1996,629160,785680,1414840
937,Cambodia,KHM,1997,643958,802210,1446168
938,Cambodia,KHM,1998,659226,819412,1478638
939,Cambodia,KHM,1999,674418,836471,1510889
940,Cambodia,KHM,2000,687832,851858,1539690
941,Cambodia,KHM,2001,700403,865844,1566247
942,Cambodia,KHM,2002,711785,878216,1590001
943,Cambodia,KHM,2003,722374,889699,1612073
944,Cambodia,KHM,2004,732386,900771,1633157
945,Cambodia,KHM,2005,741955,910872,1652827
946,Cambodia,KHM,2006,751483,920784,1672267
947,Cambodia,KHM,2007,761043,930155,1691198
948,Cambodia,KHM,2008,770840,938744,1709584
949,Cambodia,KHM,2009,780626,948366,1728992
950,Cambodia,KHM,2010,789857,958888,1748745
951,Cambodia,KHM,2011,799890,970396,1770286
952,Cambodia,KHM,2012,809108,982356,1791464
953,Cambodia,KHM,2013,818994,994649,1813643
954,Cambodia,KHM,2014,829320,1006844,1836164
955,Cambodia,KHM,2015,840266,1019842,1860108
956,Cambodia,KHM,2016,851419,1033969,1885388
957,Cambodia,KHM,2017,864140,1048595,1912735
958,Cambodia,KHM,2018,876554,1062376,1938930
959,Cambodia,KHM,2019,888712,1075262,1963974
960,Cameroon,CMR,1990,472915,520717,993632
961,Cameroon,CMR,1991,491797,540173,1031970
962,Cameroon,CMR,1992,512093,561073,1073166
963,Cameroon,CMR,1993,533633,583528,1117161
964,Cameroon,CMR,1994,556152,607480,1163632
965,Cameroon,CMR,1995,579783,632389,1212172
966,Cameroon,CMR,1996,604195,658513,1262708
967,Cameroon,CMR,1997,629914,686485,1316399
968,Cameroon,CMR,1998,656952,715544,1372496
969,Cameroon,CMR,1999,684995,745557,1430552
970,Cameroon,CMR,2000,713147,775915,1489062
971,Cameroon,CMR,2001,743147,806725,1549872
972,Cameroon,CMR,2002,773453,838439,1611892
973,Cameroon,CMR,2003,804819,870759,1675578
974,Cameroon,CMR,2004,836938,904574,1741512
975,Cameroon,CMR,2005,870633,938818,1809451
976,Cameroon,CMR,2006,905238,974391,1879629
977,Cameroon,CMR,2007,940764,1010916,1951680
978,Cameroon,CMR,2008,978220,1048552,2026772
979,Cameroon,CMR,2009,1016284,1087314,2103598
980,Cameroon,CMR,2010,1056075,1127163,2183238
981,Cameroon,CMR,2011,1095977,1167596,2263573
982,Cameroon,CMR,2012,1137228,1209586,2346814
983,Cameroon,CMR,2013,1179303,1251199,2430502
984,Cameroon,CMR,2014,1221347,1294619,2515966
985,Cameroon,CMR,2015,1264963,1339907,2604870
986,Cameroon,CMR,2016,1307913,1386625,2694538
987,Cameroon,CMR,2017,1351430,1436845,2788275
988,Cameroon,CMR,2018,1397382,1485936,2883318
989,Cameroon,CMR,2019,1445516,1535126,2980642
990,Canada,CAN,1990,1809282,2004570,3813852
991,Canada,CAN,1991,1834890,2038668,3873558
992,Canada,CAN,1992,1858119,2071193,3929312
993,Canada,CAN,1993,1880276,2102173,3982449
994,Canada,CAN,1994,1901197,2131782,4032979
995,Canada,CAN,1995,1921712,2159609,4081321
996,Canada,CAN,1996,1930557,2167886,4098443
997,Canada,CAN,1997,1925109,2147935,4073044
998,Canada,CAN,1998,1913314,2117504,4030818
999,Canada,CAN,1999,1905658,2094429,4000087
1000,Canada,CAN,2000,1911164,2095528,4006692
1001,Canada,CAN,2001,1926478,2112753,4039231
1002,Canada,CAN,2002,1941782,2127212,4068994
1003,Canada,CAN,2003,1956602,2140213,4096815
1004,Canada,CAN,2004,1972286,2153895,4126181
1005,Canada,CAN,2005,1988472,2169963,4158435
1006,Canada,CAN,2006,2021061,2202942,4224003
1007,Canada,CAN,2007,2077499,2258208,4335707
1008,Canada,CAN,2008,2143716,2321518,4465234
1009,Canada,CAN,2009,2203610,2380284,4583894
1010,Canada,CAN,2010,2241618,2419844,4661462
1011,Canada,CAN,2011,2264519,2447122,4711641
1012,Canada,CAN,2012,2288268,2475128,4763396
1013,Canada,CAN,2013,2311443,2503324,4814767
1014,Canada,CAN,2014,2334024,2529517,4863541
1015,Canada,CAN,2015,2353996,2551295,4905291
1016,Canada,CAN,2016,2372154,2569043,4941197
1017,Canada,CAN,2017,2391152,2586739,4977891
1018,Canada,CAN,2018,2408211,2601329,5009540
1019,Canada,CAN,2019,2425254,2614128,5039382
1020,Cape Verde,CPV,1990,16302,18628,34930
1021,Cape Verde,CPV,1991,16815,19051,35866
1022,Cape Verde,CPV,1992,17374,19521,36895
1023,Cape Verde,CPV,1993,17970,20036,38006
1024,Cape Verde,CPV,1994,18597,20594,39191
1025,Cape Verde,CPV,1995,19252,21171,40423
1026,Cape Verde,CPV,1996,19923,21777,41700
1027,Cape Verde,CPV,1997,20609,22394,43003
1028,Cape Verde,CPV,1998,21320,23029,44349
1029,Cape Verde,CPV,1999,22014,23658,45672
1030,Cape Verde,CPV,2000,22700,24242,46942
1031,Cape Verde,CPV,2001,23360,24801,48161
1032,Cape Verde,CPV,2002,24010,25321,49331
1033,Cape Verde,CPV,2003,24624,25825,50449
1034,Cape Verde,CPV,2004,25222,26282,51504
1035,Cape Verde,CPV,2005,25778,26721,52499
1036,Cape Verde,CPV,2006,26292,27146,53438
1037,Cape Verde,CPV,2007,26752,27546,54298
1038,Cape Verde,CPV,2008,27195,27947,55142
1039,Cape Verde,CPV,2009,27628,28335,55963
1040,Cape Verde,CPV,2010,28091,28742,56833
1041,Cape Verde,CPV,2011,28570,29158,57728
1042,Cape Verde,CPV,2012,29058,29577,58635
1043,Cape Verde,CPV,2013,29580,30009,59589
1044,Cape Verde,CPV,2014,30085,30445,60530
1045,Cape Verde,CPV,2015,30608,30875,61483
1046,Cape Verde,CPV,2016,31116,31306,62422
1047,Cape Verde,CPV,2017,31638,31745,63383
1048,Cape Verde,CPV,2018,32045,32188,64233
1049,Cape Verde,CPV,2019,32325,32669,64994
1050,Central African Republic,CAF,1990,158709,173332,332041
1051,Central African Republic,CAF,1991,163750,178269,342019
1052,Central African Republic,CAF,1992,169403,183823,353226
1053,Central African Republic,CAF,1993,174777,189065,363842
1054,Central African Republic,CAF,1994,179813,193979,373792
1055,Central African Republic,CAF,1995,184998,199087,384085
1056,Central African Republic,CAF,1996,190753,204636,395389
1057,Central African Republic,CAF,1997,197024,210594,407618
1058,Central African Republic,CAF,1998,203743,216963,420706
1059,Central African Republic,CAF,1999,210035,223148,433183
1060,Central African Republic,CAF,2000,215824,228905,444729
1061,Central African Republic,CAF,2001,221951,234998,456949
1062,Central African Republic,CAF,2002,228191,241298,469489
1063,Central African Republic,CAF,2003,234552,247670,482222
1064,Central African Republic,CAF,2004,240707,254110,494817
1065,Central African Republic,CAF,2005,246211,259999,506210
1066,Central African Republic,CAF,2006,251192,265565,516757
1067,Central African Republic,CAF,2007,256522,271427,527949
1068,Central African Republic,CAF,2008,262815,278123,540938
1069,Central African Republic,CAF,2009,269952,285775,555727
1070,Central African Republic,CAF,2010,277765,294212,571977
1071,Central African Republic,CAF,2011,284533,301953,586486
1072,Central African Republic,CAF,2012,286945,306477,593422
1073,Central African Republic,CAF,2013,286192,308584,594776
1074,Central African Republic,CAF,2014,287969,312757,600726
1075,Central African Republic,CAF,2015,293905,320143,614048
1076,Central African Republic,CAF,2016,301121,328374,629495
1077,Central African Republic,CAF,2017,308252,336530,644782
1078,Central African Republic,CAF,2018,316589,346000,662589
1079,Central African Republic,CAF,2019,325932,356415,682347
1080,Chad,TCD,1990,289333,329808,619141
1081,Chad,TCD,1991,297781,338470,636251
1082,Chad,TCD,1992,306758,347621,654379
1083,Chad,TCD,1993,316168,357362,673530
1084,Chad,TCD,1994,326185,367603,693788
1085,Chad,TCD,1995,336789,378512,715301
1086,Chad,TCD,1996,348428,390653,739081
1087,Chad,TCD,1997,361312,404057,765369
1088,Chad,TCD,1998,375032,418306,793338
1089,Chad,TCD,1999,389233,432718,821951
1090,Chad,TCD,2000,403327,446774,850101
1091,Chad,TCD,2001,417366,460640,878006
1092,Chad,TCD,2002,431603,474825,906428
1093,Chad,TCD,2003,446041,488742,934783
1094,Chad,TCD,2004,461206,503672,964878
1095,Chad,TCD,2005,476805,518900,995705
1096,Chad,TCD,2006,493275,534597,1027872
1097,Chad,TCD,2007,509777,550969,1060746
1098,Chad,TCD,2008,527050,567887,1094937
1099,Chad,TCD,2009,545460,586072,1131532
1100,Chad,TCD,2010,564829,605601,1170430
1101,Chad,TCD,2011,585191,626693,1211884
1102,Chad,TCD,2012,606470,648458,1254928
1103,Chad,TCD,2013,628685,671394,1300079
1104,Chad,TCD,2014,652084,695535,1347619
1105,Chad,TCD,2015,676610,721433,1398043
1106,Chad,TCD,2016,702427,748165,1450592
1107,Chad,TCD,2017,729432,776525,1505957
1108,Chad,TCD,2018,758587,806743,1565330
1109,Chad,TCD,2019,789802,839461,1629263
1110,Chile,CHL,1990,781201,1169020,1950221
1111,Chile,CHL,1991,791252,1186684,1977936
1112,Chile,CHL,1992,801792,1204104,2005896
1113,Chile,CHL,1993,812263,1221600,2033863
1114,Chile,CHL,1994,823102,1238784,2061886
1115,Chile,CHL,1995,834346,1256350,2090696
1116,Chile,CHL,1996,844770,1273733,2118503
1117,Chile,CHL,1997,855153,1290067,2145220
1118,Chile,CHL,1998,865043,1306042,2171085
1119,Chile,CHL,1999,875824,1323226,2199050
1120,Chile,CHL,2000,887609,1341891,2229500
1121,Chile,CHL,2001,904593,1360797,2265390
1122,Chile,CHL,2002,928143,1378591,2306734
1123,Chile,CHL,2003,953965,1395672,2349637
1124,Chile,CHL,2004,976706,1411798,2388504
1125,Chile,CHL,2005,992212,1428779,2420991
1126,Chile,CHL,2006,1000010,1442278,2442288
1127,Chile,CHL,2007,1003189,1449758,2452947
1128,Chile,CHL,2008,1004314,1454551,2458865
1129,Chile,CHL,2009,1005644,1460465,2466109
1130,Chile,CHL,2010,1009770,1471132,2480902
1131,Chile,CHL,2011,1015971,1485367,2501338
1132,Chile,CHL,2012,1021181,1498837,2520018
1133,Chile,CHL,2013,1026383,1511736,2538119
1134,Chile,CHL,2014,1031329,1524246,2555575
1135,Chile,CHL,2015,1038505,1538648,2577153
1136,Chile,CHL,2016,1052634,1556002,2608636
1137,Chile,CHL,2017,1068685,1574457,2643142
1138,Chile,CHL,2018,1078805,1588859,2667664
1139,Chile,CHL,2019,1085366,1598896,2684262
1140,China,CHN,1990,67652491,64975588,132628079
1141,China,CHN,1991,69467699,66108651,135576350
1142,China,CHN,1992,71155090,67173118,138328208
1143,China,CHN,1993,72675923,68197961,140873884
1144,China,CHN,1994,73981283,69187115,143168398
1145,China,CHN,1995,75029873,70150753,145180626
1146,China,CHN,1996,75766283,71186322,146952605
1147,China,CHN,1997,76236258,72360387,148596645
1148,China,CHN,1998,76544675,73574862,150119537
1149,China,CHN,1999,76793472,74732109,151525581
1150,China,CHN,2000,77058444,75693881,152752325
1151,China,CHN,2001,77242000,76250719,153492719
1152,China,CHN,2002,77227356,76375564,153602920
1153,China,CHN,2003,77115760,76256808,153372568
1154,China,CHN,2004,76980755,76137424,153118179
1155,China,CHN,2005,76930676,76273687,153204363
1156,China,CHN,2006,76983792,76550043,153533835
1157,China,CHN,2007,77050427,76729761,153780188
1158,China,CHN,2008,77114486,76873682,153988168
1159,China,CHN,2009,77168402,77063090,154231492
1160,China,CHN,2010,77213398,77356166,154569564
1161,China,CHN,2011,77197309,77629501,154826810
1162,China,CHN,2012,77122876,77778944,154901820
1163,China,CHN,2013,77059484,77924017,154983501
1164,China,CHN,2014,77080565,78158222,155238787
1165,China,CHN,2015,77272335,78591750,155864085
1166,China,CHN,2016,77933480,79662428,157595908
1167,China,CHN,2017,78663250,80758836,159422086
1168,China,CHN,2018,78934119,81190004,160124123
1169,China,CHN,2019,78905611,81257083,160162694
1170,Colombia,COL,1990,1714106,1904431,3618537
1171,Colombia,COL,1991,1751780,1952488,3704268
1172,Colombia,COL,1992,1789789,2001978,3791767
1173,Colombia,COL,1993,1829888,2052635,3882523
1174,Colombia,COL,1994,1871659,2105936,3977595
1175,Colombia,COL,1995,1913310,2159384,4072694
1176,Colombia,COL,1996,1965440,2226783,4192223
1177,Colombia,COL,1997,2032961,2313352,4346313
1178,Colombia,COL,1998,2106232,2406335,4512567
1179,Colombia,COL,1999,2176010,2494274,4670284
1180,Colombia,COL,2000,2229827,2562559,4792386
1181,Colombia,COL,2001,2271946,2616147,4888093
1182,Colombia,COL,2002,2312263,2669194,4981457
1183,Colombia,COL,2003,2349937,2719981,5069918
1184,Colombia,COL,2004,2386496,2766615,5153111
1185,Colombia,COL,2005,2420066,2808446,5228512
1186,Colombia,COL,2006,2429619,2806092,5235711
1187,Colombia,COL,2007,2405679,2744320,5149999
1188,Colombia,COL,2008,2368212,2657570,5025782
1189,Colombia,COL,2009,2335605,2583927,4919532
1190,Colombia,COL,2010,2331747,2561613,4893360
1191,Colombia,COL,2011,2348775,2579261,4928036
1192,Colombia,COL,2012,2363852,2597207,4961059
1193,Colombia,COL,2013,2376057,2614516,4990573
1194,Colombia,COL,2014,2390513,2635581,5026094
1195,Colombia,COL,2015,2408258,2662291,5070549
1196,Colombia,COL,2016,2494777,2789042,5283819
1197,Colombia,COL,2017,2597726,2929621,5527347
1198,Colombia,COL,2018,2629280,2970723,5600003
1199,Colombia,COL,2019,2641563,2993678,5635241
1200,Comoros,COM,1990,22527,23918,46445
1201,Comoros,COM,1991,23076,24532,47608
1202,Comoros,COM,1992,23625,25139,48764
1203,Comoros,COM,1993,24156,25721,49877
1204,Comoros,COM,1994,24682,26304,50986
1205,Comoros,COM,1995,25202,26865,52067
1206,Comoros,COM,1996,25702,27424,53126
1207,Comoros,COM,1997,26184,27976,54160
1208,Comoros,COM,1998,26667,28527,55194
1209,Comoros,COM,1999,27160,29081,56241
1210,Comoros,COM,2000,27670,29632,57302
1211,Comoros,COM,2001,28186,30179,58365
1212,Comoros,COM,2002,28697,30727,59424
1213,Comoros,COM,2003,29246,31272,60518
1214,Comoros,COM,2004,29798,31823,61621
1215,Comoros,COM,2005,30354,32381,62735
1216,Comoros,COM,2006,30917,32972,63889
1217,Comoros,COM,2007,31473,33549,65022
1218,Comoros,COM,2008,32019,34145,66164
1219,Comoros,COM,2009,32595,34749,67344
1220,Comoros,COM,2010,33170,35388,68558
1221,Comoros,COM,2011,33781,36067,69848
1222,Comoros,COM,2012,34412,36775,71187
1223,Comoros,COM,2013,35050,37499,72549
1224,Comoros,COM,2014,35686,38227,73913
1225,Comoros,COM,2015,36346,38999,75345
1226,Comoros,COM,2016,37015,39793,76808
1227,Comoros,COM,2017,37680,40581,78261
1228,Comoros,COM,2018,38399,41276,79675
1229,Comoros,COM,2019,39116,41963,81079
1230,Congo,COG,1990,127840,142114,269954
1231,Congo,COG,1991,132175,146764,278939
1232,Congo,COG,1992,136666,151606,288272
1233,Congo,COG,1993,141201,156542,297743
1234,Congo,COG,1994,145765,161583,307348
1235,Congo,COG,1995,150375,166755,317130
1236,Congo,COG,1996,155159,172290,327449
1237,Congo,COG,1997,159511,178096,337607
1238,Congo,COG,1998,163847,184204,348051
1239,Congo,COG,1999,168690,190445,359135
1240,Congo,COG,2000,173618,196447,370065
1241,Congo,COG,2001,178651,202139,380790
1242,Congo,COG,2002,183636,207909,391545
1243,Congo,COG,2003,188744,213760,402504
1244,Congo,COG,2004,193931,219618,413549
1245,Congo,COG,2005,199228,225719,424947
1246,Congo,COG,2006,204725,231906,436631
1247,Congo,COG,2007,210149,238260,448409
1248,Congo,COG,2008,215714,244513,460227
1249,Congo,COG,2009,221514,250847,472361
1250,Congo,COG,2010,227705,257525,485230
1251,Congo,COG,2011,234198,263942,498140
1252,Congo,COG,2012,240936,270054,510990
1253,Congo,COG,2013,247731,276543,524274
1254,Congo,COG,2014,254852,283140,537992
1255,Congo,COG,2015,262158,290502,552660
1256,Congo,COG,2016,269698,298713,568411
1257,Congo,COG,2017,277470,307313,584783
1258,Congo,COG,2018,285371,315922,601293
1259,Congo,COG,2019,293627,324733,618360
1260,Cook Islands,COK,1990,1019,985,2004
1261,Cook Islands,COK,1991,1025,995,2020
1262,Cook Islands,COK,1992,1030,1004,2034
1263,Cook Islands,COK,1993,1032,1011,2043
1264,Cook Islands,COK,1994,1033,1017,2050
1265,Cook Islands,COK,1995,1033,1022,2055
1266,Cook Islands,COK,1996,1030,1025,2055
1267,Cook Islands,COK,1997,1024,1024,2048
1268,Cook Islands,COK,1998,1018,1022,2040
1269,Cook Islands,COK,1999,1013,1020,2033
1270,Cook Islands,COK,2000,1013,1021,2034
1271,Cook Islands,COK,2001,1016,1027,2043
1272,Cook Islands,COK,2002,1024,1039,2063
1273,Cook Islands,COK,2003,1036,1056,2092
1274,Cook Islands,COK,2004,1048,1076,2124
1275,Cook Islands,COK,2005,1057,1095,2152
1276,Cook Islands,COK,2006,1060,1110,2170
1277,Cook Islands,COK,2007,1052,1115,2167
1278,Cook Islands,COK,2008,1036,1113,2149
1279,Cook Islands,COK,2009,1016,1107,2123
1280,Cook Islands,COK,2010,996,1099,2095
1281,Cook Islands,COK,2011,979,1092,2071
1282,Cook Islands,COK,2012,968,1090,2058
1283,Cook Islands,COK,2013,961,1091,2052
1284,Cook Islands,COK,2014,957,1095,2052
1285,Cook Islands,COK,2015,954,1100,2054
1286,Cook Islands,COK,2016,951,1105,2056
1287,Cook Islands,COK,2017,949,1110,2059
1288,Cook Islands,COK,2018,949,1116,2065
1289,Cook Islands,COK,2019,952,1123,2075
1290,Costa Rica,CRI,1990,167445,179677,347122
1291,Costa Rica,CRI,1991,173091,185767,358858
1292,Costa Rica,CRI,1992,178928,191940,370868
1293,Costa Rica,CRI,1993,184822,198330,383152
1294,Costa Rica,CRI,1994,190758,204823,395581
1295,Costa Rica,CRI,1995,196729,211419,408148
1296,Costa Rica,CRI,1996,202563,218165,420728
1297,Costa Rica,CRI,1997,208377,224766,433143
1298,Costa Rica,CRI,1998,213902,231433,445335
1299,Costa Rica,CRI,1999,219215,238034,457249
1300,Costa Rica,CRI,2000,224108,244258,468366
1301,Costa Rica,CRI,2001,228657,250200,478857
1302,Costa Rica,CRI,2002,232924,255957,488881
1303,Costa Rica,CRI,2003,236783,261610,498393
1304,Costa Rica,CRI,2004,240209,266868,507077
1305,Costa Rica,CRI,2005,243311,271924,515235
1306,Costa Rica,CRI,2006,246124,276671,522795
1307,Costa Rica,CRI,2007,248742,281379,530121
1308,Costa Rica,CRI,2008,251243,286001,537244
1309,Costa Rica,CRI,2009,253649,290361,544010
1310,Costa Rica,CRI,2010,255758,294581,550339
1311,Costa Rica,CRI,2011,257785,298833,556618
1312,Costa Rica,CRI,2012,259895,303294,563189
1313,Costa Rica,CRI,2013,262053,307756,569809
1314,Costa Rica,CRI,2014,264174,312068,576242
1315,Costa Rica,CRI,2015,266140,316032,582172
1316,Costa Rica,CRI,2016,268208,319783,587991
1317,Costa Rica,CRI,2017,270013,323198,593211
1318,Costa Rica,CRI,2018,271816,326585,598401
1319,Costa Rica,CRI,2019,273657,329893,603550
1320,Cote d'Ivoire,CIV,1990,568388,545513,1113901
1321,Cote d'Ivoire,CIV,1991,593661,570025,1163686
1322,Cote d'Ivoire,CIV,1992,619126,595669,1214795
1323,Cote d'Ivoire,CIV,1993,645280,622013,1267293
1324,Cote d'Ivoire,CIV,1994,671465,648306,1319771
1325,Cote d'Ivoire,CIV,1995,697423,674510,1371933
1326,Cote d'Ivoire,CIV,1996,723249,700422,1423671
1327,Cote d'Ivoire,CIV,1997,748787,725867,1474654
1328,Cote d'Ivoire,CIV,1998,774018,750326,1524344
1329,Cote d'Ivoire,CIV,1999,798045,774123,1572168
1330,Cote d'Ivoire,CIV,2000,821726,796909,1618635
1331,Cote d'Ivoire,CIV,2001,845301,819253,1664554
1332,Cote d'Ivoire,CIV,2002,868316,841089,1709405
1333,Cote d'Ivoire,CIV,2003,891290,862767,1754057
1334,Cote d'Ivoire,CIV,2004,914230,883950,1798180
1335,Cote d'Ivoire,CIV,2005,936849,904855,1841704
1336,Cote d'Ivoire,CIV,2006,960142,925174,1885316
1337,Cote d'Ivoire,CIV,2007,983784,945596,1929380
1338,Cote d'Ivoire,CIV,2008,1007595,966056,1973651
1339,Cote d'Ivoire,CIV,2009,1032148,986989,2019137
1340,Cote d'Ivoire,CIV,2010,1057120,1008744,2065864
1341,Cote d'Ivoire,CIV,2011,1082715,1031359,2114074
1342,Cote d'Ivoire,CIV,2012,1108832,1056229,2165061
1343,Cote d'Ivoire,CIV,2013,1135721,1082213,2217934
1344,Cote d'Ivoire,CIV,2014,1163088,1108327,2271415
1345,Cote d'Ivoire,CIV,2015,1190546,1134655,2325201
1346,Cote d'Ivoire,CIV,2016,1217592,1161443,2379035
1347,Cote d'Ivoire,CIV,2017,1245238,1188789,2434027
1348,Cote d'Ivoire,CIV,2018,1275402,1217677,2493079
1349,Cote d'Ivoire,CIV,2019,1307380,1247473,2554853
1350,Croatia,HRV,1990,258163,338303,596466
1351,Croatia,HRV,1991,257779,337967,595746
1352,Croatia,HRV,1992,256701,336984,593685
1353,Croatia,HRV,1993,255332,335622,590954
1354,Croatia,HRV,1994,253568,333958,587526
1355,Croatia,HRV,1995,251628,332054,583682
1356,Croatia,HRV,1996,249406,329710,579116
1357,Croatia,HRV,1997,247045,327029,574074
1358,Croatia,HRV,1998,244629,324214,568843
1359,Croatia,HRV,1999,242277,321242,563519
1360,Croatia,HRV,2000,240216,318498,558714
1361,Croatia,HRV,2001,238344,315864,554208
1362,Croatia,HRV,2002,236615,313390,550005
1363,Croatia,HRV,2003,234949,310970,545919
1364,Croatia,HRV,2004,233474,308808,542282
1365,Croatia,HRV,2005,232121,307077,539198
1366,Croatia,HRV,2006,231007,305684,536691
1367,Croatia,HRV,2007,229934,304370,534304
1368,Croatia,HRV,2008,228892,303184,532076
1369,Croatia,HRV,2009,228021,302065,530086
1370,Croatia,HRV,2010,227316,301219,528535
1371,Croatia,HRV,2011,226715,300398,527113
1372,Croatia,HRV,2012,226152,299669,525821
1373,Croatia,HRV,2013,225726,299057,524783
1374,Croatia,HRV,2014,225360,298525,523885
1375,Croatia,HRV,2015,224848,297812,522660
1376,Croatia,HRV,2016,224603,297566,522169
1377,Croatia,HRV,2017,224203,297276,521479
1378,Croatia,HRV,2018,223545,296679,520224
1379,Croatia,HRV,2019,222649,295965,518614
1380,Cuba,CUB,1990,809207,900112,1709319
1381,Cuba,CUB,1991,813989,905114,1719103
1382,Cuba,CUB,1992,819025,909353,1728378
1383,Cuba,CUB,1993,824611,913366,1737977
1384,Cuba,CUB,1994,829910,916886,1746796
1385,Cuba,CUB,1995,835031,920431,1755462
1386,Cuba,CUB,1996,839576,923330,1762906
1387,Cuba,CUB,1997,843286,926213,1769499
1388,Cuba,CUB,1998,846636,928890,1775526
1389,Cuba,CUB,1999,849779,930464,1780243
1390,Cuba,CUB,2000,852650,931501,1784151
1391,Cuba,CUB,2001,854648,930653,1785301
1392,Cuba,CUB,2002,855822,928654,1784476
1393,Cuba,CUB,2003,856602,925341,1781943
1394,Cuba,CUB,2004,856523,921875,1778398
1395,Cuba,CUB,2005,855798,918389,1774187
1396,Cuba,CUB,2006,854828,914904,1769732
1397,Cuba,CUB,2007,853664,910586,1764250
1398,Cuba,CUB,2008,851975,906501,1758476
1399,Cuba,CUB,2009,849772,903478,1753250
1400,Cuba,CUB,2010,847636,902547,1750183
1401,Cuba,CUB,2011,846034,903241,1749275
1402,Cuba,CUB,2012,845091,904549,1749640
1403,Cuba,CUB,2013,844159,906081,1750240
1404,Cuba,CUB,2014,842945,907126,1750071
1405,Cuba,CUB,2015,840714,907189,1747903
1406,Cuba,CUB,2016,836888,907037,1743925
1407,Cuba,CUB,2017,832729,906444,1739173
1408,Cuba,CUB,2018,831264,905718,1736982
1409,Cuba,CUB,2019,832428,904599,1737027
1410,Cyprus,CYP,1990,52009,62666,114675
1411,Cyprus,CYP,1991,52991,63753,116744
1412,Cyprus,CYP,1992,53976,64878,118854
1413,Cyprus,CYP,1993,54934,66039,120973
1414,Cyprus,CYP,1994,55943,67204,123147
1415,Cyprus,CYP,1995,56955,68460,125415
1416,Cyprus,CYP,1996,57997,69762,127759
1417,Cyprus,CYP,1997,59089,71144,130233
1418,Cyprus,CYP,1998,60189,72562,132751
1419,Cyprus,CYP,1999,61310,74044,135354
1420,Cyprus,CYP,2000,62484,75555,138039
1421,Cyprus,CYP,2001,63678,77236,140914
1422,Cyprus,CYP,2002,64934,79081,144015
1423,Cyprus,CYP,2003,66258,81012,147270
1424,Cyprus,CYP,2004,67607,83016,150623
1425,Cyprus,CYP,2005,68998,85071,154069
1426,Cyprus,CYP,2006,70363,87068,157431
1427,Cyprus,CYP,2007,71747,89058,160805
1428,Cyprus,CYP,2008,73129,91054,164183
1429,Cyprus,CYP,2009,74538,93071,167609
1430,Cyprus,CYP,2010,75948,95171,171119
1431,Cyprus,CYP,2011,77359,97345,174704
1432,Cyprus,CYP,2012,78754,99560,178314
1433,Cyprus,CYP,2013,80144,101766,181910
1434,Cyprus,CYP,2014,81488,103863,185351
1435,Cyprus,CYP,2015,82806,105787,188593
1436,Cyprus,CYP,2016,83953,107390,191343
1437,Cyprus,CYP,2017,85107,108888,193995
1438,Cyprus,CYP,2018,86348,110811,197159
1439,Cyprus,CYP,2019,87660,113113,200773
1440,Czechia,CZE,1990,518907,675867,1194774
1441,Czechia,CZE,1991,519467,677987,1197454
1442,Czechia,CZE,1992,519889,679822,1199711
1443,Czechia,CZE,1993,520142,681410,1201552
1444,Czechia,CZE,1994,520664,682706,1203370
1445,Czechia,CZE,1995,521153,683583,1204736
1446,Czechia,CZE,1996,521224,683597,1204821
1447,Czechia,CZE,1997,521443,682286,1203729
1448,Czechia,CZE,1998,521249,680673,1201922
1449,Czechia,CZE,1999,521456,679118,1200574
1450,Czechia,CZE,2000,521740,678147,1199887
1451,Czechia,CZE,2001,522391,677736,1200127
1452,Czechia,CZE,2002,523098,677381,1200479
1453,Czechia,CZE,2003,523739,677316,1201055
1454,Czechia,CZE,2004,524143,676896,1201039
1455,Czechia,CZE,2005,524737,676648,1201385
1456,Czechia,CZE,2006,525237,676386,1201623
1457,Czechia,CZE,2007,525667,676241,1201908
1458,Czechia,CZE,2008,526072,675952,1202024
1459,Czechia,CZE,2009,526648,675818,1202466
1460,Czechia,CZE,2010,527475,675899,1203374
1461,Czechia,CZE,2011,527914,675887,1203801
1462,Czechia,CZE,2012,528098,676032,1204130
1463,Czechia,CZE,2013,528295,675977,1204272
1464,Czechia,CZE,2014,528910,676110,1205020
1465,Czechia,CZE,2015,529414,676407,1205821
1466,Czechia,CZE,2016,530435,675792,1206227
1467,Czechia,CZE,2017,531297,675401,1206698
1468,Czechia,CZE,2018,531663,676466,1208129
1469,Czechia,CZE,2019,532054,678855,1210909
1470,Democratic Republic of Congo,COD,1990,2057944,2228628,4286572
1471,Democratic Republic of Congo,COD,1991,2127502,2295147,4422649
1472,Democratic Republic of Congo,COD,1992,2200635,2364945,4565580
1473,Democratic Republic of Congo,COD,1993,2277598,2436353,4713951
1474,Democratic Republic of Congo,COD,1994,2357523,2512710,4870233
1475,Democratic Republic of Congo,COD,1995,2442985,2592541,5035526
1476,Democratic Republic of Congo,COD,1996,2530927,2675976,5206903
1477,Democratic Republic of Congo,COD,1997,2623911,2765274,5389185
1478,Democratic Republic of Congo,COD,1998,2720534,2857040,5577574
1479,Democratic Republic of Congo,COD,1999,2821178,2952605,5773783
1480,Democratic Republic of Congo,COD,2000,2922791,3049146,5971937
1481,Democratic Republic of Congo,COD,2001,3026237,3144565,6170802
1482,Democratic Republic of Congo,COD,2002,3132950,3244949,6377899
1483,Democratic Republic of Congo,COD,2003,3242973,3345240,6588213
1484,Democratic Republic of Congo,COD,2004,3352451,3447275,6799726
1485,Democratic Republic of Congo,COD,2005,3461679,3549958,7011637
1486,Democratic Republic of Congo,COD,2006,3571726,3655100,7226826
1487,Democratic Republic of Congo,COD,2007,3683246,3761702,7444948
1488,Democratic Republic of Congo,COD,2008,3795663,3871832,7667495
1489,Democratic Republic of Congo,COD,2009,3912726,3988189,7900915
1490,Democratic Republic of Congo,COD,2010,4033941,4108388,8142329
1491,Democratic Republic of Congo,COD,2011,4153258,4228519,8381777
1492,Democratic Republic of Congo,COD,2012,4267678,4345433,8613111
1493,Democratic Republic of Congo,COD,2013,4377274,4460283,8837557
1494,Democratic Republic of Congo,COD,2014,4488816,4579462,9068278
1495,Democratic Republic of Congo,COD,2015,4609186,4705665,9314851
1496,Democratic Republic of Congo,COD,2016,4730372,4839227,9569599
1497,Democratic Republic of Congo,COD,2017,4860681,4978343,9839024
1498,Democratic Republic of Congo,COD,2018,5003750,5125687,10129437
1499,Democratic Republic of Congo,COD,2019,5158165,5279104,10437269
1500,Denmark,DNK,1990,312384,435798,748182
1501,Denmark,DNK,1991,312208,435257,747465
1502,Denmark,DNK,1992,311967,434289,746256
1503,Denmark,DNK,1993,311717,433261,744978
1504,Denmark,DNK,1994,311566,431995,743561
1505,Denmark,DNK,1995,311613,430796,742409
1506,Denmark,DNK,1996,311664,429321,740985
1507,Denmark,DNK,1997,311550,427193,738743
1508,Denmark,DNK,1998,311334,425159,736493
1509,Denmark,DNK,1999,311108,423053,734161
1510,Denmark,DNK,2000,311300,421701,733001
1511,Denmark,DNK,2001,311797,420738,732535
1512,Denmark,DNK,2002,312350,419774,732124
1513,Denmark,DNK,2003,312950,418869,731819
1514,Denmark,DNK,2004,313614,418549,732163
1515,Denmark,DNK,2005,314577,418843,733420
1516,Denmark,DNK,2006,315558,419659,735217
1517,Denmark,DNK,2007,316729,420494,737223
1518,Denmark,DNK,2008,318158,421694,739852
1519,Denmark,DNK,2009,319678,423372,743050
1520,Denmark,DNK,2010,321118,425459,746577
1521,Denmark,DNK,2011,322904,427973,750877
1522,Denmark,DNK,2012,324523,430676,755199
1523,Denmark,DNK,2013,326346,433579,759925
1524,Denmark,DNK,2014,328548,436482,765030
1525,Denmark,DNK,2015,330823,439249,770072
1526,Denmark,DNK,2016,333204,441112,774316
1527,Denmark,DNK,2017,335351,442725,778076
1528,Denmark,DNK,2018,337717,445148,782865
1529,Denmark,DNK,2019,340335,448255,788590
1530,Djibouti,DJI,1990,24933,21621,46554
1531,Djibouti,DJI,1991,24494,21519,46013
1532,Djibouti,DJI,1992,24663,21831,46494
1533,Djibouti,DJI,1993,25819,22779,48598
1534,Djibouti,DJI,1994,26878,23692,50570
1535,Djibouti,DJI,1995,27709,24470,52179
1536,Djibouti,DJI,1996,28908,25516,54424
1537,Djibouti,DJI,1997,30514,26866,57380
1538,Djibouti,DJI,1998,32104,28220,60324
1539,Djibouti,DJI,1999,33613,29549,63162
1540,Djibouti,DJI,2000,35080,30889,65969
1541,Djibouti,DJI,2001,36652,32298,68950
1542,Djibouti,DJI,2002,38341,33798,72139
1543,Djibouti,DJI,2003,39822,35189,75011
1544,Djibouti,DJI,2004,41045,36428,77473
1545,Djibouti,DJI,2005,42260,37699,79959
1546,Djibouti,DJI,2006,43652,39172,82824
1547,Djibouti,DJI,2007,45215,40813,86028
1548,Djibouti,DJI,2008,46897,42566,89463
1549,Djibouti,DJI,2009,48686,44401,93087
1550,Djibouti,DJI,2010,50531,46271,96802
1551,Djibouti,DJI,2011,52319,48079,100398
1552,Djibouti,DJI,2012,54098,49874,103972
1553,Djibouti,DJI,2013,55834,51639,107473
1554,Djibouti,DJI,2014,57569,53414,110983
1555,Djibouti,DJI,2015,59425,55296,114721
1556,Djibouti,DJI,2016,61334,57213,118547
1557,Djibouti,DJI,2017,63235,59130,122365
1558,Djibouti,DJI,2018,65159,61022,126181
1559,Djibouti,DJI,2019,67160,62882,130042
1560,Dominica,DMA,1990,5002,4903,9905
1561,Dominica,DMA,1991,4969,4867,9836
1562,Dominica,DMA,1992,4938,4831,9769
1563,Dominica,DMA,1993,4909,4801,9710
1564,Dominica,DMA,1994,4881,4774,9655
1565,Dominica,DMA,1995,4860,4759,9619
1566,Dominica,DMA,1996,4841,4748,9589
1567,Dominica,DMA,1997,4827,4742,9569
1568,Dominica,DMA,1998,4816,4739,9555
1569,Dominica,DMA,1999,4811,4737,9548
1570,Dominica,DMA,2000,4809,4734,9543
1571,Dominica,DMA,2001,4810,4729,9539
1572,Dominica,DMA,2002,4815,4723,9538
1573,Dominica,DMA,2003,4823,4717,9540
1574,Dominica,DMA,2004,4831,4712,9543
1575,Dominica,DMA,2005,4841,4709,9550
1576,Dominica,DMA,2006,4848,4704,9552
1577,Dominica,DMA,2007,4855,4698,9553
1578,Dominica,DMA,2008,4866,4691,9557
1579,Dominica,DMA,2009,4875,4689,9564
1580,Dominica,DMA,2010,4885,4691,9576
1581,Dominica,DMA,2011,4896,4704,9600
1582,Dominica,DMA,2012,4907,4721,9628
1583,Dominica,DMA,2013,4919,4743,9662
1584,Dominica,DMA,2014,4927,4763,9690
1585,Dominica,DMA,2015,4930,4775,9705
1586,Dominica,DMA,2016,4921,4782,9703
1587,Dominica,DMA,2017,4912,4788,9700
1588,Dominica,DMA,2018,4907,4807,9714
1589,Dominica,DMA,2019,4907,4841,9748
1590,Dominican Republic,DOM,1990,482093,503247,985340
1591,Dominican Republic,DOM,1991,490592,515281,1005873
1592,Dominican Republic,DOM,1992,499918,527002,1026920
1593,Dominican Republic,DOM,1993,510047,538275,1048322
1594,Dominican Republic,DOM,1994,520495,549213,1069708
1595,Dominican Republic,DOM,1995,531716,559876,1091592
1596,Dominican Republic,DOM,1996,543646,570506,1114152
1597,Dominican Republic,DOM,1997,556068,581672,1137740
1598,Dominican Republic,DOM,1998,569016,593226,1162242
1599,Dominican Republic,DOM,1999,581890,604422,1186312
1600,Dominican Republic,DOM,2000,594678,615123,1209801
1601,Dominican Republic,DOM,2001,607517,624999,1232516
1602,Dominican Republic,DOM,2002,620367,634883,1255250
1603,Dominican Republic,DOM,2003,632675,644622,1277297
1604,Dominican Republic,DOM,2004,644461,654385,1298846
1605,Dominican Republic,DOM,2005,655216,664342,1319558
1606,Dominican Republic,DOM,2006,665264,673731,1338995
1607,Dominican Republic,DOM,2007,674888,682969,1357857
1608,Dominican Republic,DOM,2008,683856,692535,1376391
1609,Dominican Republic,DOM,2009,692998,701869,1394867
1610,Dominican Republic,DOM,2010,701589,711369,1412958
1611,Dominican Republic,DOM,2011,710284,720443,1430727
1612,Dominican Republic,DOM,2012,718782,729211,1447993
1613,Dominican Republic,DOM,2013,726892,737480,1464372
1614,Dominican Republic,DOM,2014,734597,746192,1480789
1615,Dominican Republic,DOM,2015,742318,755404,1497722
1616,Dominican Republic,DOM,2016,749620,765177,1514797
1617,Dominican Republic,DOM,2017,756414,775068,1531482
1618,Dominican Republic,DOM,2018,765567,785630,1551197
1619,Dominican Republic,DOM,2019,775487,796873,1572360
1620,East Asia & Pacific (WB),,1990,104033678,103975590,208009268
1621,East Asia & Pacific (WB),,1991,106301544,105644525,211946069
1622,East Asia & Pacific (WB),,1992,108433239,107251091,215684330
1623,East Asia & Pacific (WB),,1993,110396746,108819927,219216673
1624,East Asia & Pacific (WB),,1994,112137340,110365136,222502476
1625,East Asia & Pacific (WB),,1995,113628843,111893317,225522160
1626,East Asia & Pacific (WB),,1996,114812258,113530873,228343131
1627,East Asia & Pacific (WB),,1997,115720678,115352546,231073224
1628,East Asia & Pacific (WB),,1998,116469347,117225184,233694531
1629,East Asia & Pacific (WB),,1999,117147302,119026853,236174155
1630,East Asia & Pacific (WB),,2000,117850397,120582096,238432493
1631,East Asia & Pacific (WB),,2001,118487110,121695710,240182820
1632,East Asia & Pacific (WB),,2002,118925725,122357421,241283146
1633,East Asia & Pacific (WB),,2003,119257472,122767992,242025464
1634,East Asia & Pacific (WB),,2004,119565018,123171402,242736420
1635,East Asia & Pacific (WB),,2005,119944322,123826511,243770833
1636,East Asia & Pacific (WB),,2006,120470057,124626731,245096788
1637,East Asia & Pacific (WB),,2007,121032230,125315290,246347520
1638,East Asia & Pacific (WB),,2008,121461826,125861658,247323484
1639,East Asia & Pacific (WB),,2009,121752482,126372782,248125264
1640,East Asia & Pacific (WB),,2010,122107099,127048804,249155903
1641,East Asia & Pacific (WB),,2011,122482048,127782908,250264956
1642,East Asia & Pacific (WB),,2012,122808517,128412436,251220953
1643,East Asia & Pacific (WB),,2013,123147523,129044492,252192015
1644,East Asia & Pacific (WB),,2014,123555692,129750842,253306534
1645,East Asia & Pacific (WB),,2015,124130590,130653497,254784087
1646,East Asia & Pacific (WB),,2016,125132458,132087559,257220017
1647,East Asia & Pacific (WB),,2017,126189378,133538760,259728138
1648,East Asia & Pacific (WB),,2018,126829222,134435095,261264317
1649,East Asia & Pacific (WB),,2019,127202334,134993433,262195767
1650,Eastern Mediterranean Region (WHO),,1990,25488246,24856634,50344880
1651,Eastern Mediterranean Region (WHO),,1991,26188076,25597437,51785513
1652,Eastern Mediterranean Region (WHO),,1992,26939249,26381191,53320440
1653,Eastern Mediterranean Region (WHO),,1993,27689554,27159855,54849409
1654,Eastern Mediterranean Region (WHO),,1994,28400851,27918243,56319094
1655,Eastern Mediterranean Region (WHO),,1995,29110896,28679672,57790568
1656,Eastern Mediterranean Region (WHO),,1996,29854188,29448972,59303160
1657,Eastern Mediterranean Region (WHO),,1997,30628048,30215635,60843683
1658,Eastern Mediterranean Region (WHO),,1998,31382603,30970196,62352799
1659,Eastern Mediterranean Region (WHO),,1999,32114498,31723757,63838255
1660,Eastern Mediterranean Region (WHO),,2000,32840483,32507314,65347797
1661,Eastern Mediterranean Region (WHO),,2001,33592922,33354144,66947066
1662,Eastern Mediterranean Region (WHO),,2002,34389843,34257952,68647795
1663,Eastern Mediterranean Region (WHO),,2003,35194438,35183162,70377600
1664,Eastern Mediterranean Region (WHO),,2004,35995896,36116223,72112119
1665,Eastern Mediterranean Region (WHO),,2005,36812281,37039269,73851550
1666,Eastern Mediterranean Region (WHO),,2006,37689926,37974036,75663962
1667,Eastern Mediterranean Region (WHO),,2007,38697761,38981768,77679529
1668,Eastern Mediterranean Region (WHO),,2008,39790265,40030023,79820288
1669,Eastern Mediterranean Region (WHO),,2009,40841370,41047493,81888863
1670,Eastern Mediterranean Region (WHO),,2010,41780996,42018722,83799718
1671,Eastern Mediterranean Region (WHO),,2011,42751478,42987597,85739075
1672,Eastern Mediterranean Region (WHO),,2012,43779090,43983203,87762293
1673,Eastern Mediterranean Region (WHO),,2013,44789675,44979743,89769418
1674,Eastern Mediterranean Region (WHO),,2014,45760582,45950857,91711439
1675,Eastern Mediterranean Region (WHO),,2015,46727064,46921862,93648926
1676,Eastern Mediterranean Region (WHO),,2016,47670169,47842764,95512933
1677,Eastern Mediterranean Region (WHO),,2017,48626261,48800687,97426948
1678,Eastern Mediterranean Region (WHO),,2018,49643271,49928075,99571346
1679,Eastern Mediterranean Region (WHO),,2019,50696354,51195231,101891585
1680,Ecuador,ECU,1990,624282,679168,1303450
1681,Ecuador,ECU,1991,638903,695105,1334008
1682,Ecuador,ECU,1992,653452,711692,1365144
1683,Ecuador,ECU,1993,668282,728444,1396726
1684,Ecuador,ECU,1994,683329,745847,1429176
1685,Ecuador,ECU,1995,698613,763589,1462202
1686,Ecuador,ECU,1996,714053,782491,1496544
1687,Ecuador,ECU,1997,729744,802039,1531783
1688,Ecuador,ECU,1998,745574,822258,1567832
1689,Ecuador,ECU,1999,761685,842400,1604085
1690,Ecuador,ECU,2000,778519,862742,1641261
1691,Ecuador,ECU,2001,795571,882509,1678080
1692,Ecuador,ECU,2002,813539,902624,1716163
1693,Ecuador,ECU,2003,831677,922883,1754560
1694,Ecuador,ECU,2004,850580,943301,1793881
1695,Ecuador,ECU,2005,869285,963892,1833177
1696,Ecuador,ECU,2006,887468,985379,1872847
1697,Ecuador,ECU,2007,906137,1006789,1912926
1698,Ecuador,ECU,2008,924871,1028788,1953659
1699,Ecuador,ECU,2009,943591,1050783,1994374
1700,Ecuador,ECU,2010,962226,1073309,2035535
1701,Ecuador,ECU,2011,981991,1096612,2078603
1702,Ecuador,ECU,2012,1001808,1120282,2122090
1703,Ecuador,ECU,2013,1022237,1143985,2166222
1704,Ecuador,ECU,2014,1041913,1167118,2209031
1705,Ecuador,ECU,2015,1061091,1190456,2251547
1706,Ecuador,ECU,2016,1084541,1215840,2300381
1707,Ecuador,ECU,2017,1111713,1244987,2356700
1708,Ecuador,ECU,2018,1135288,1271127,2406415
1709,Ecuador,ECU,2019,1154375,1294757,2449132
1710,Egypt,EGY,1990,3837102,3831062,7668164
1711,Egypt,EGY,1991,3922075,3929286,7851361
1712,Egypt,EGY,1992,4004974,4027234,8032208
1713,Egypt,EGY,1993,4086967,4122787,8209754
1714,Egypt,EGY,1994,4167504,4217078,8384582
1715,Egypt,EGY,1995,4247352,4311871,8559223
1716,Egypt,EGY,1996,4310733,4387478,8698211
1717,Egypt,EGY,1997,4355890,4436009,8791899
1718,Egypt,EGY,1998,4392866,4474976,8867842
1719,Egypt,EGY,1999,4437147,4522573,8959720
1720,Egypt,EGY,2000,4505835,4597376,9103211
1721,Egypt,EGY,2001,4595577,4700229,9295806
1722,Egypt,EGY,2002,4686658,4804368,9491026
1723,Egypt,EGY,2003,4780489,4908656,9689145
1724,Egypt,EGY,2004,4872941,5013529,9886470
1725,Egypt,EGY,2005,4967737,5119742,10087479
1726,Egypt,EGY,2006,5074957,5242163,10317120
1727,Egypt,EGY,2007,5203587,5390750,10594337
1728,Egypt,EGY,2008,5341968,5551193,10893161
1729,Egypt,EGY,2009,5478116,5705748,11183864
1730,Egypt,EGY,2010,5597345,5836145,11433490
1731,Egypt,EGY,2011,5714451,5949225,11663676
1732,Egypt,EGY,2012,5843750,6076958,11920708
1733,Egypt,EGY,2013,5978097,6207241,12185338
1734,Egypt,EGY,2014,6110981,6333820,12444801
1735,Egypt,EGY,2015,6237632,6451742,12689374
1736,Egypt,EGY,2016,6350877,6551585,12902462
1737,Egypt,EGY,2017,6469232,6655666,13124898
1738,Egypt,EGY,2018,6592475,6784800,13377275
1739,Egypt,EGY,2019,6722395,6938036,13660431
1740,El Salvador,SLV,1990,291457,343278,634735
1741,El Salvador,SLV,1991,294019,348651,642670
1742,El Salvador,SLV,1992,296283,353792,650075
1743,El Salvador,SLV,1993,298338,358572,656910
1744,El Salvador,SLV,1994,300224,363142,663366
1745,El Salvador,SLV,1995,301879,367697,669576
1746,El Salvador,SLV,1996,303593,371735,675328
1747,El Salvador,SLV,1997,305101,375217,680318
1748,El Salvador,SLV,1998,306503,378516,685019
1749,El Salvador,SLV,1999,308204,381772,689976
1750,El Salvador,SLV,2000,310086,385374,695460
1751,El Salvador,SLV,2001,312260,389058,701318
1752,El Salvador,SLV,2002,314671,392851,707522
1753,El Salvador,SLV,2003,317184,396625,713809
1754,El Salvador,SLV,2004,319487,400449,719936
1755,El Salvador,SLV,2005,321658,404258,725916
1756,El Salvador,SLV,2006,323814,408022,731836
1757,El Salvador,SLV,2007,325826,411886,737712
1758,El Salvador,SLV,2008,327879,415718,743597
1759,El Salvador,SLV,2009,329802,419601,749403
1760,El Salvador,SLV,2010,331594,423433,755027
1761,El Salvador,SLV,2011,333198,427071,760269
1762,El Salvador,SLV,2012,334717,430474,765191
1763,El Salvador,SLV,2013,335920,433623,769543
1764,El Salvador,SLV,2014,336947,436863,773810
1765,El Salvador,SLV,2015,337765,440113,777878
1766,El Salvador,SLV,2016,338814,443387,782201
1767,El Salvador,SLV,2017,340101,446675,786776
1768,El Salvador,SLV,2018,341443,449544,790987
1769,El Salvador,SLV,2019,342785,451765,794550
1770,England,,1990,3235773,3713095,6948868
1771,England,,1991,3226140,3721627,6947767
1772,England,,1992,3219911,3731285,6951196
1773,England,,1993,3218278,3742167,6960445
1774,England,,1994,3222847,3754806,6977653
1775,England,,1995,3234214,3768837,7003051
1776,England,,1996,3250694,3784173,7034867
1777,England,,1997,3269066,3800587,7069653
1778,England,,1998,3289174,3817793,7106967
1779,England,,1999,3309935,3834847,7144782
1780,England,,2000,3331410,3851408,7182818
1781,England,,2001,3348993,3863118,7212111
1782,England,,2002,3359387,3867329,7226716
1783,England,,2003,3366801,3868605,7235406
1784,England,,2004,3376433,3872309,7248742
1785,England,,2005,3393045,3884138,7277183
1786,England,,2006,3420295,3908920,7329215
1787,England,,2007,3455725,3944252,7399977
1788,England,,2008,3496117,3984728,7480845
1789,England,,2009,3537465,4025144,7562609
1790,England,,2010,3576352,4060141,7636493
1791,England,,2011,3619508,4100608,7720116
1792,England,,2012,3671716,4153853,7825569
1793,England,,2013,3725676,4210451,7936127
1794,England,,2014,3774419,4260735,8035154
1795,England,,2015,3810613,4295080,8105693
1796,England,,2016,3820033,4297255,8117288
1797,England,,2017,3828033,4297712,8125745
1798,England,,2018,3851253,4316818,8168071
1799,England,,2019,3874177,4336379,8210556
1800,Equatorial Guinea,GNQ,1990,22295,26370,48665
1801,Equatorial Guinea,GNQ,1991,23130,27367,50497
1802,Equatorial Guinea,GNQ,1992,24051,28417,52468
1803,Equatorial Guinea,GNQ,1993,25036,29526,54562
1804,Equatorial Guinea,GNQ,1994,26091,30694,56785
1805,Equatorial Guinea,GNQ,1995,27228,31930,59158
1806,Equatorial Guinea,GNQ,1996,28307,33104,61411
1807,Equatorial Guinea,GNQ,1997,29280,34187,63467
1808,Equatorial Guinea,GNQ,1998,30227,35251,65478
1809,Equatorial Guinea,GNQ,1999,31260,36376,67636
1810,Equatorial Guinea,GNQ,2000,32535,37673,70208
1811,Equatorial Guinea,GNQ,2001,34049,39148,73197
1812,Equatorial Guinea,GNQ,2002,35655,40651,76306
1813,Equatorial Guinea,GNQ,2003,37436,42249,79685
1814,Equatorial Guinea,GNQ,2004,39376,43957,83333
1815,Equatorial Guinea,GNQ,2005,41522,45784,87306
1816,Equatorial Guinea,GNQ,2006,43851,47673,91524
1817,Equatorial Guinea,GNQ,2007,46287,49638,95925
1818,Equatorial Guinea,GNQ,2008,48877,51696,100573
1819,Equatorial Guinea,GNQ,2009,51608,53807,105415
1820,Equatorial Guinea,GNQ,2010,54504,55998,110502
1821,Equatorial Guinea,GNQ,2011,57531,58264,115795
1822,Equatorial Guinea,GNQ,2012,60704,60669,121373
1823,Equatorial Guinea,GNQ,2013,63984,63158,127142
1824,Equatorial Guinea,GNQ,2014,67334,65706,133040
1825,Equatorial Guinea,GNQ,2015,70736,68257,138993
1826,Equatorial Guinea,GNQ,2016,74167,70752,144919
1827,Equatorial Guinea,GNQ,2017,77624,73291,150915
1828,Equatorial Guinea,GNQ,2018,81168,75940,157108
1829,Equatorial Guinea,GNQ,2019,84849,78686,163535
1830,Eritrea,ERI,1990,160069,167669,327738
1831,Eritrea,ERI,1991,157132,164577,321709
1832,Eritrea,ERI,1992,164236,171725,335961
1833,Eritrea,ERI,1993,172426,179982,352408
1834,Eritrea,ERI,1994,180180,187780,367960
1835,Eritrea,ERI,1995,186416,194146,380562
1836,Eritrea,ERI,1996,190923,198994,389917
1837,Eritrea,ERI,1997,195222,203747,398969
1838,Eritrea,ERI,1998,199023,207775,406798
1839,Eritrea,ERI,1999,202498,211956,414454
1840,Eritrea,ERI,2000,208423,218512,426935
1841,Eritrea,ERI,2001,218917,228942,447859
1842,Eritrea,ERI,2002,231502,241344,472846
1843,Eritrea,ERI,2003,241439,251175,492614
1844,Eritrea,ERI,2004,249113,258612,507725
1845,Eritrea,ERI,2005,256810,266099,522909
1846,Eritrea,ERI,2006,264917,274151,539068
1847,Eritrea,ERI,2007,274019,283093,557112
1848,Eritrea,ERI,2008,283077,291932,575009
1849,Eritrea,ERI,2009,291546,300478,592024
1850,Eritrea,ERI,2010,299469,308625,608094
1851,Eritrea,ERI,2011,307080,316411,623491
1852,Eritrea,ERI,2012,314334,323862,638196
1853,Eritrea,ERI,2013,320606,330519,651125
1854,Eritrea,ERI,2014,327042,337227,664269
1855,Eritrea,ERI,2015,333880,344634,678514
1856,Eritrea,ERI,2016,341313,353075,694388
1857,Eritrea,ERI,2017,349814,362575,712389
1858,Eritrea,ERI,2018,359443,372655,732098
1859,Eritrea,ERI,2019,369871,382770,752641
1860,Estonia,EST,1990,86432,119100,205532
1861,Estonia,EST,1991,86184,118557,204741
1862,Estonia,EST,1992,85337,117544,202881
1863,Estonia,EST,1993,83909,116055,199964
1864,Estonia,EST,1994,82278,114326,196604
1865,Estonia,EST,1995,80809,112838,193647
1866,Estonia,EST,1996,79753,111836,191589
1867,Estonia,EST,1997,79179,111373,190552
1868,Estonia,EST,1998,78942,111277,190219
1869,Estonia,EST,1999,78982,111343,190325
1870,Estonia,EST,2000,79203,111347,190550
1871,Estonia,EST,2001,79037,110818,189855
1872,Estonia,EST,2002,78373,109756,188129
1873,Estonia,EST,2003,77445,108424,185869
1874,Estonia,EST,2004,76373,106992,183365
1875,Estonia,EST,2005,75433,105546,180979
1876,Estonia,EST,2006,74536,104228,178764
1877,Estonia,EST,2007,73626,102884,176510
1878,Estonia,EST,2008,72840,101602,174442
1879,Estonia,EST,2009,72202,100417,172619
1880,Estonia,EST,2010,71715,99471,171186
1881,Estonia,EST,2011,71298,98517,169815
1882,Estonia,EST,2012,70883,97552,168435
1883,Estonia,EST,2013,70560,96694,167254
1884,Estonia,EST,2014,70387,95985,166372
1885,Estonia,EST,2015,70332,95555,165887
1886,Estonia,EST,2016,70417,95150,165567
1887,Estonia,EST,2017,70508,94768,165276
1888,Estonia,EST,2018,70645,94636,165281
1889,Estonia,EST,2019,70768,94706,165474
1890,Eswatini,SWZ,1990,35204,40168,75372
1891,Eswatini,SWZ,1991,36394,41529,77923
1892,Eswatini,SWZ,1992,37638,42928,80566
1893,Eswatini,SWZ,1993,38852,44342,83194
1894,Eswatini,SWZ,1994,40089,45746,85835
1895,Eswatini,SWZ,1995,41299,47168,88467
1896,Eswatini,SWZ,1996,42472,48540,91012
1897,Eswatini,SWZ,1997,43542,49876,93418
1898,Eswatini,SWZ,1998,44558,51156,95714
1899,Eswatini,SWZ,1999,45468,52324,97792
1900,Eswatini,SWZ,2000,46271,53370,99641
1901,Eswatini,SWZ,2001,46977,54260,101237
1902,Eswatini,SWZ,2002,47606,55057,102663
1903,Eswatini,SWZ,2003,48160,55744,103904
1904,Eswatini,SWZ,2004,48632,56315,104947
1905,Eswatini,SWZ,2005,49040,56748,105788
1906,Eswatini,SWZ,2006,49457,57140,106597
1907,Eswatini,SWZ,2007,49866,57502,107368
1908,Eswatini,SWZ,2008,50299,57870,108169
1909,Eswatini,SWZ,2009,50723,58278,109001
1910,Eswatini,SWZ,2010,51192,58683,109875
1911,Eswatini,SWZ,2011,51751,59156,110907
1912,Eswatini,SWZ,2012,52374,59710,112084
1913,Eswatini,SWZ,2013,53063,60342,113405
1914,Eswatini,SWZ,2014,53775,60972,114747
1915,Eswatini,SWZ,2015,54562,61574,116136
1916,Eswatini,SWZ,2016,55330,62249,117579
1917,Eswatini,SWZ,2017,56130,62969,119099
1918,Eswatini,SWZ,2018,56948,63527,120475
1919,Eswatini,SWZ,2019,57809,63994,121803
1920,Ethiopia,ETH,1990,2795059,2927419,5722478
1921,Ethiopia,ETH,1991,2906671,3023414,5930085
1922,Ethiopia,ETH,1992,3008602,3111593,6120195
1923,Ethiopia,ETH,1993,3122478,3211053,6333531
1924,Ethiopia,ETH,1994,3236838,3312187,6549025
1925,Ethiopia,ETH,1995,3341369,3408188,6749557
1926,Ethiopia,ETH,1996,3438890,3498286,6937176
1927,Ethiopia,ETH,1997,3532339,3581666,7114005
1928,Ethiopia,ETH,1998,3622160,3660385,7282545
1929,Ethiopia,ETH,1999,3707893,3736793,7444686
1930,Ethiopia,ETH,2000,3789684,3812622,7602306
1931,Ethiopia,ETH,2001,3872068,3880207,7752275
1932,Ethiopia,ETH,2002,3955797,3934023,7889820
1933,Ethiopia,ETH,2003,4038900,3984030,8022930
1934,Ethiopia,ETH,2004,4124107,4039113,8163220
1935,Ethiopia,ETH,2005,4212629,4111021,8323650
1936,Ethiopia,ETH,2006,4297016,4193308,8490324
1937,Ethiopia,ETH,2007,4374585,4271302,8645887
1938,Ethiopia,ETH,2008,4450065,4348649,8798714
1939,Ethiopia,ETH,2009,4531233,4434447,8965680
1940,Ethiopia,ETH,2010,4622391,4531618,9154009
1941,Ethiopia,ETH,2011,4721601,4641358,9362959
1942,Ethiopia,ETH,2012,4822348,4763076,9585424
1943,Ethiopia,ETH,2013,4929799,4892876,9822675
1944,Ethiopia,ETH,2014,5039750,5026831,10066581
1945,Ethiopia,ETH,2015,5153813,5160041,10313854
1946,Ethiopia,ETH,2016,5277290,5299269,10576559
1947,Ethiopia,ETH,2017,5403077,5441941,10845018
1948,Ethiopia,ETH,2018,5535906,5582269,11118175
1949,Ethiopia,ETH,2019,5674958,5722538,11397496
1950,Europe & Central Asia (WB),,1990,50085181,62898538,112983719
1951,Europe & Central Asia (WB),,1991,50319852,63248356,113568208
1952,Europe & Central Asia (WB),,1992,50534484,63576555,114111039
1953,Europe & Central Asia (WB),,1993,50720830,63872632,114593462
1954,Europe & Central Asia (WB),,1994,50885298,64132299,115017597
1955,Europe & Central Asia (WB),,1995,51041540,64377165,115418705
1956,Europe & Central Asia (WB),,1996,51242508,64643260,115885768
1957,Europe & Central Asia (WB),,1997,51484684,64943462,116428146
1958,Europe & Central Asia (WB),,1998,51734898,65245469,116980367
1959,Europe & Central Asia (WB),,1999,51971666,65528422,117500088
1960,Europe & Central Asia (WB),,2000,52169587,65778593,117948180
1961,Europe & Central Asia (WB),,2001,52318322,65977288,118295610
1962,Europe & Central Asia (WB),,2002,52444020,66137131,118581151
1963,Europe & Central Asia (WB),,2003,52538857,66270158,118809015
1964,Europe & Central Asia (WB),,2004,52623851,66401943,119025794
1965,Europe & Central Asia (WB),,2005,52691806,66556586,119248392
1966,Europe & Central Asia (WB),,2006,52780577,66792859,119573436
1967,Europe & Central Asia (WB),,2007,52896824,67120088,120016912
1968,Europe & Central Asia (WB),,2008,53021736,67472460,120494196
1969,Europe & Central Asia (WB),,2009,53134678,67791402,120926080
1970,Europe & Central Asia (WB),,2010,53234979,68026645,121261624
1971,Europe & Central Asia (WB),,2011,53346508,68211538,121558046
1972,Europe & Central Asia (WB),,2012,53509282,68402577,121911859
1973,Europe & Central Asia (WB),,2013,53710740,68597336,122308076
1974,Europe & Central Asia (WB),,2014,53923203,68787511,122710714
1975,Europe & Central Asia (WB),,2015,54108155,68957578,123065733
1976,Europe & Central Asia (WB),,2016,54261076,69033760,123294836
1977,Europe & Central Asia (WB),,2017,54420652,69091108,123511760
1978,Europe & Central Asia (WB),,2018,54580776,69131455,123712231
1979,Europe & Central Asia (WB),,2019,54737818,69098425,123836243
1980,European Region (WHO),,1990,50527512,63395129,113922641
1981,European Region (WHO),,1991,50772885,63759190,114532075
1982,European Region (WHO),,1992,50998140,64101457,115099597
1983,European Region (WHO),,1993,51194782,64410718,115605500
1984,European Region (WHO),,1994,51369344,64683097,116052441
1985,European Region (WHO),,1995,51535800,64940222,116476022
1986,European Region (WHO),,1996,51746080,65216469,116962549
1987,European Region (WHO),,1997,51999888,65527474,117527362
1988,European Region (WHO),,1998,52261544,65839359,118100903
1989,European Region (WHO),,1999,52500211,66125176,118625387
1990,European Region (WHO),,2000,52700995,66379830,119080825
1991,European Region (WHO),,2001,52860297,66589608,119449905
1992,European Region (WHO),,2002,52996518,66760688,119757206
1993,European Region (WHO),,2003,53100503,66903969,120004472
1994,European Region (WHO),,2004,53194148,67045460,120239608
1995,European Region (WHO),,2005,53271064,67210159,120481223
1996,European Region (WHO),,2006,53370803,67459587,120830390
1997,European Region (WHO),,2007,53500475,67803701,121304176
1998,European Region (WHO),,2008,53639506,68174631,121814137
1999,European Region (WHO),,2009,53765948,68510732,122276680
2000,European Region (WHO),,2010,53877362,68759287,122636649
2001,European Region (WHO),,2011,53998155,68953174,122951329
2002,European Region (WHO),,2012,54169296,69151072,123320368
2003,European Region (WHO),,2013,54379296,69351864,123731160
2004,European Region (WHO),,2014,54600307,69548627,124148934
2005,European Region (WHO),,2015,54794797,69727364,124522161
2006,European Region (WHO),,2016,54959570,69812316,124771886
2007,European Region (WHO),,2017,55131341,69878765,125010106
2008,European Region (WHO),,2018,55302520,69930954,125233474
2009,European Region (WHO),,2019,55471018,69911035,125382053
2010,Fiji,FJI,1990,40035,40379,80414
2011,Fiji,FJI,1991,40480,40845,81325
2012,Fiji,FJI,1992,40910,41285,82195
2013,Fiji,FJI,1993,41329,41720,83049
2014,Fiji,FJI,1994,41735,42142,83877
2015,Fiji,FJI,1995,42128,42564,84692
2016,Fiji,FJI,1996,42529,43000,85529
2017,Fiji,FJI,1997,42937,43484,86421
2018,Fiji,FJI,1998,43375,43954,87329
2019,Fiji,FJI,1999,43807,44467,88274
2020,Fiji,FJI,2000,44216,44950,89166
2021,Fiji,FJI,2001,44630,45411,90041
2022,Fiji,FJI,2002,45046,45872,90918
2023,Fiji,FJI,2003,45454,46306,91760
2024,Fiji,FJI,2004,45839,46749,92588
2025,Fiji,FJI,2005,46208,47199,93407
2026,Fiji,FJI,2006,46563,47648,94211
2027,Fiji,FJI,2007,46872,48061,94933
2028,Fiji,FJI,2008,47158,48451,95609
2029,Fiji,FJI,2009,47396,48783,96179
2030,Fiji,FJI,2010,47630,49097,96727
2031,Fiji,FJI,2011,47861,49375,97236
2032,Fiji,FJI,2012,48079,49644,97723
2033,Fiji,FJI,2013,48338,49918,98256
2034,Fiji,FJI,2014,48545,50185,98730
2035,Fiji,FJI,2015,48751,50471,99222
2036,Fiji,FJI,2016,48851,50760,99611
2037,Fiji,FJI,2017,48926,51058,99984
2038,Fiji,FJI,2018,49156,51416,100572
2039,Fiji,FJI,2019,49468,51776,101244
2040,Finland,FIN,1990,363274,405546,768820
2041,Finland,FIN,1991,360022,398848,758870
2042,Finland,FIN,1992,357433,393439,750872
2043,Finland,FIN,1993,355530,389207,744737
2044,Finland,FIN,1994,354376,386663,741039
2045,Finland,FIN,1995,354044,385775,739819
2046,Finland,FIN,1996,354289,387188,741477
2047,Finland,FIN,1997,354859,390652,745511
2048,Finland,FIN,1998,355550,395173,750723
2049,Finland,FIN,1999,356311,399131,755442
2050,Finland,FIN,2000,356980,401292,758272
2051,Finland,FIN,2001,356276,400748,757024
2052,Finland,FIN,2002,354200,398370,752570
2053,Finland,FIN,2003,351585,395352,746937
2054,Finland,FIN,2004,349614,392863,742477
2055,Finland,FIN,2005,349494,392207,741701
2056,Finland,FIN,2006,351459,395098,746557
2057,Finland,FIN,2007,354628,401124,755752
2058,Finland,FIN,2008,358320,408504,766824
2059,Finland,FIN,2009,361743,414861,776604
2060,Finland,FIN,2010,363914,418162,782076
2061,Finland,FIN,2011,364968,417557,782525
2062,Finland,FIN,2012,365390,414765,780155
2063,Finland,FIN,2013,365737,410951,776688
2064,Finland,FIN,2014,366194,407943,774137
2065,Finland,FIN,2015,367130,406797,773927
2066,Finland,FIN,2016,367121,405119,772240
2067,Finland,FIN,2017,367141,403363,770504
2068,Finland,FIN,2018,369070,405272,774342
2069,Finland,FIN,2019,371587,408795,780382
2070,France,FRA,1990,3943060,5525266,9468326
2071,France,FRA,1991,3938656,5487524,9426180
2072,France,FRA,1992,3933399,5458173,9391572
2073,France,FRA,1993,3930574,5438919,9369493
2074,France,FRA,1994,3930894,5433387,9364281
2075,France,FRA,1995,3937457,5445114,9382571
2076,France,FRA,1996,3949657,5493449,9443106
2077,France,FRA,1997,3968676,5578610,9547286
2078,France,FRA,1998,3988881,5681082,9669963
2079,France,FRA,1999,4011139,5775680,9786819
2080,France,FRA,2000,4029987,5843972,9873959
2081,France,FRA,2001,4045019,5884620,9929639
2082,France,FRA,2002,4052889,5915452,9968341
2083,France,FRA,2003,4055607,5940249,9995856
2084,France,FRA,2004,4063375,5965938,10029313
2085,France,FRA,2005,4078389,5995533,10073922
2086,France,FRA,2006,4098207,6018845,10117052
2087,France,FRA,2007,4118644,6029454,10148098
2088,France,FRA,2008,4139625,6033168,10172793
2089,France,FRA,2009,4158395,6038419,10196814
2090,France,FRA,2010,4178569,6051287,10229856
2091,France,FRA,2011,4197540,6056304,10253844
2092,France,FRA,2012,4217206,6035331,10252537
2093,France,FRA,2013,4236575,6008323,10244898
2094,France,FRA,2014,4256769,5988517,10245286
2095,France,FRA,2015,4274809,5996442,10271251
2096,France,FRA,2016,4293353,6022329,10315682
2097,France,FRA,2017,4310197,6048843,10359040
2098,France,FRA,2018,4324944,6071623,10396567
2099,France,FRA,2019,4340151,6090960,10431111
2100,G20,,1990,224455736,238150642,462606378
2101,G20,,1991,228753665,242381734,471135399
2102,G20,,1992,232902210,246531951,479434161
2103,G20,,1993,236841686,250556179,487397865
2104,G20,,1994,240497681,254430680,494928361
2105,G20,,1995,243816252,258113754,501930006
2106,G20,,1996,246832934,262056759,508889693
2107,G20,,1997,249635974,266537026,516173000
2108,G20,,1998,252298552,271252511,523551063
2109,G20,,1999,254920334,275891052,530811386
2110,G20,,2000,257540685,280137718,537678403
2111,G20,,2001,260104603,283863139,543967742
2112,G20,,2002,262524057,287204351,549728408
2113,G20,,2003,264848229,290296792,555145021
2114,G20,,2004,267134909,293325854,560460763
2115,G20,,2005,269407160,296425441,565832601
2116,G20,,2006,271547510,299180175,570727685
2117,G20,,2007,273455266,301286027,574741293
2118,G20,,2008,275240478,303087841,578328319
2119,G20,,2009,277034583,304996899,582031482
2120,G20,,2010,279024048,307422472,586446520
2121,G20,,2011,281061974,309977500,591039474
2122,G20,,2012,282965111,312105073,595070184
2123,G20,,2013,284857414,314113724,598971138
2124,G20,,2014,286843800,316252878,603096678
2125,G20,,2015,289042375,318798649,607841024
2126,G20,,2016,291839255,321964125,613803380
2127,G20,,2017,294641565,325110195,619751760
2128,G20,,2018,296826828,327661061,624487889
2129,G20,,2019,298682912,329732582,628415494
2130,Gabon,GAB,1990,54043,56671,110714
2131,Gabon,GAB,1991,55397,58266,113663
2132,Gabon,GAB,1992,56755,59915,116670
2133,Gabon,GAB,1993,58173,61587,119760
2134,Gabon,GAB,1994,59589,63282,122871
2135,Gabon,GAB,1995,61031,65001,126032
2136,Gabon,GAB,1996,62490,66792,129282
2137,Gabon,GAB,1997,63958,68612,132570
2138,Gabon,GAB,1998,65466,70506,135972
2139,Gabon,GAB,1999,66979,72386,139365
2140,Gabon,GAB,2000,68518,74237,142755
2141,Gabon,GAB,2001,70052,76075,146127
2142,Gabon,GAB,2002,71576,77951,149527
2143,Gabon,GAB,2003,73048,79825,152873
2144,Gabon,GAB,2004,74586,81725,156311
2145,Gabon,GAB,2005,76140,83666,159806
2146,Gabon,GAB,2006,77756,85563,163319
2147,Gabon,GAB,2007,79283,87372,166655
2148,Gabon,GAB,2008,80829,89112,169941
2149,Gabon,GAB,2009,82403,90933,173336
2150,Gabon,GAB,2010,84044,92936,176980
2151,Gabon,GAB,2011,85798,95121,180919
2152,Gabon,GAB,2012,87520,97341,184861
2153,Gabon,GAB,2013,89359,99684,189043
2154,Gabon,GAB,2014,91179,102094,193273
2155,Gabon,GAB,2015,93003,104527,197530
2156,Gabon,GAB,2016,94846,107166,202012
2157,Gabon,GAB,2017,96723,109820,206543
2158,Gabon,GAB,2018,98566,112240,210806
2159,Gabon,GAB,2019,100408,114441,214849
2160,Gambia,GMB,1990,45869,56416,102285
2161,Gambia,GMB,1991,47979,59138,107117
2162,Gambia,GMB,1992,50055,61891,111946
2163,Gambia,GMB,1993,52078,64640,116718
2164,Gambia,GMB,1994,54010,67318,121328
2165,Gambia,GMB,1995,55855,69826,125681
2166,Gambia,GMB,1996,57616,72300,129916
2167,Gambia,GMB,1997,59296,74704,134000
2168,Gambia,GMB,1998,60907,77117,138024
2169,Gambia,GMB,1999,62491,79510,142001
2170,Gambia,GMB,2000,64045,81937,145982
2171,Gambia,GMB,2001,65586,84422,150008
2172,Gambia,GMB,2002,67179,86840,154019
2173,Gambia,GMB,2003,68869,89319,158188
2174,Gambia,GMB,2004,70659,91818,162477
2175,Gambia,GMB,2005,72506,94345,166851
2176,Gambia,GMB,2006,74482,96793,171275
2177,Gambia,GMB,2007,76550,99082,175632
2178,Gambia,GMB,2008,78708,101337,180045
2179,Gambia,GMB,2009,81036,103813,184849
2180,Gambia,GMB,2010,83474,106624,190098
2181,Gambia,GMB,2011,86099,109835,195934
2182,Gambia,GMB,2012,88870,113239,202109
2183,Gambia,GMB,2013,91793,116733,208526
2184,Gambia,GMB,2014,94691,120377,215068
2185,Gambia,GMB,2015,97673,124116,221789
2186,Gambia,GMB,2016,100644,127900,228544
2187,Gambia,GMB,2017,103578,131702,235280
2188,Gambia,GMB,2018,106636,135785,242421
2189,Gambia,GMB,2019,109800,139981,249781
2190,Georgia,GEO,1990,265551,323692,589243
2191,Georgia,GEO,1991,265533,322947,588480
2192,Georgia,GEO,1992,264815,321497,586312
2193,Georgia,GEO,1993,263234,319318,582552
2194,Georgia,GEO,1994,261306,316599,577905
2195,Georgia,GEO,1995,259194,314014,573208
2196,Georgia,GEO,1996,257103,311587,568690
2197,Georgia,GEO,1997,254979,309156,564135
2198,Georgia,GEO,1998,252444,306188,558632
2199,Georgia,GEO,1999,249143,302486,551629
2200,Georgia,GEO,2000,245187,298108,543295
2201,Georgia,GEO,2001,240740,293139,533879
2202,Georgia,GEO,2002,235808,287756,523564
2203,Georgia,GEO,2003,230651,281922,512573
2204,Georgia,GEO,2004,225737,276221,501958
2205,Georgia,GEO,2005,221184,270845,492029
2206,Georgia,GEO,2006,217071,265849,482920
2207,Georgia,GEO,2007,213144,261094,474238
2208,Georgia,GEO,2008,209354,256682,466036
2209,Georgia,GEO,2009,205843,252301,458144
2210,Georgia,GEO,2010,202692,248270,450962
2211,Georgia,GEO,2011,199662,244534,444196
2212,Georgia,GEO,2012,197101,241135,438236
2213,Georgia,GEO,2013,194869,238092,432961
2214,Georgia,GEO,2014,192929,235325,428254
2215,Georgia,GEO,2015,191085,232847,423932
2216,Georgia,GEO,2016,189228,230413,419641
2217,Georgia,GEO,2017,187484,228032,415516
2218,Georgia,GEO,2018,186017,225798,411815
2219,Georgia,GEO,2019,184971,223750,408721
2220,Germany,DEU,1990,4734600,6642008,11376608
2221,Germany,DEU,1991,4740105,6728248,11468353
2222,Germany,DEU,1992,4755661,6812961,11568622
2223,Germany,DEU,1993,4772772,6885526,11658298
2224,Germany,DEU,1994,4787543,6936826,11724369
2225,Germany,DEU,1995,4803457,6967561,11771018
2226,Germany,DEU,1996,4820570,6970229,11790799
2227,Germany,DEU,1997,4839186,6958675,11797861
2228,Germany,DEU,1998,4857700,6938850,11796550
2229,Germany,DEU,1999,4878270,6916715,11794985
2230,Germany,DEU,2000,4900834,6902785,11803619
2231,Germany,DEU,2001,4932115,6900100,11832215
2232,Germany,DEU,2002,4976224,6901432,11877656
2233,Germany,DEU,2003,5020181,6899479,11919660
2234,Germany,DEU,2004,5057885,6891583,11949468
2235,Germany,DEU,2005,5077844,6876296,11954140
2236,Germany,DEU,2006,5090412,6886405,11976817
2237,Germany,DEU,2007,5104444,6941288,12045732
2238,Germany,DEU,2008,5114829,7013157,12127986
2239,Germany,DEU,2009,5116242,7071453,12187695
2240,Germany,DEU,2010,5109235,7095824,12205059
2241,Germany,DEU,2011,5098296,7098379,12196675
2242,Germany,DEU,2012,5104538,7122718,12227256
2243,Germany,DEU,2013,5123113,7152540,12275653
2244,Germany,DEU,2014,5155984,7188427,12344411
2245,Germany,DEU,2015,5199050,7220335,12419385
2246,Germany,DEU,2016,5245427,7241417,12486844
2247,Germany,DEU,2017,5299898,7260705,12560603
2248,Germany,DEU,2018,5341174,7262226,12603400
2249,Germany,DEU,2019,5367617,7242109,12609726
2250,Ghana,GHA,1990,712792,753465,1466257
2251,Ghana,GHA,1991,731646,773564,1505210
2252,Ghana,GHA,1992,751036,793830,1544866
2253,Ghana,GHA,1993,770867,815058,1585925
2254,Ghana,GHA,1994,791392,836799,1628191
2255,Ghana,GHA,1995,812375,859236,1671611
2256,Ghana,GHA,1996,834157,882574,1716731
2257,Ghana,GHA,1997,855532,906725,1762257
2258,Ghana,GHA,1998,876997,931989,1808986
2259,Ghana,GHA,1999,900062,957965,1858027
2260,Ghana,GHA,2000,924264,986089,1910353
2261,Ghana,GHA,2001,950248,1015674,1965922
2262,Ghana,GHA,2002,977227,1046947,2024174
2263,Ghana,GHA,2003,1005000,1080009,2085009
2264,Ghana,GHA,2004,1033658,1114693,2148351
2265,Ghana,GHA,2005,1063009,1150879,2213888
2266,Ghana,GHA,2006,1092843,1187645,2280488
2267,Ghana,GHA,2007,1123857,1224677,2348534
2268,Ghana,GHA,2008,1154617,1263050,2417667
2269,Ghana,GHA,2009,1186034,1302073,2488107
2270,Ghana,GHA,2010,1218671,1342297,2560968
2271,Ghana,GHA,2011,1251860,1383460,2635320
2272,Ghana,GHA,2012,1286315,1425559,2711874
2273,Ghana,GHA,2013,1321001,1466636,2787637
2274,Ghana,GHA,2014,1355686,1509868,2865554
2275,Ghana,GHA,2015,1391384,1553953,2945337
2276,Ghana,GHA,2016,1425222,1597842,3023064
2277,Ghana,GHA,2017,1460104,1643271,3103375
2278,Ghana,GHA,2018,1496720,1687677,3184397
2279,Ghana,GHA,2019,1533478,1732438,3265916
2280,Greece,GRC,1990,750599,963453,1714052
2281,Greece,GRC,1991,757220,969848,1727068
2282,Greece,GRC,1992,766283,979019,1745302
2283,Greece,GRC,1993,774039,987789,1761828
2284,Greece,GRC,1994,781118,995993,1777111
2285,Greece,GRC,1995,787327,1003917,1791244
2286,Greece,GRC,1996,798161,1018913,1817074
2287,Greece,GRC,1997,815321,1044378,1859699
2288,Greece,GRC,1998,835237,1073491,1908728
2289,Greece,GRC,1999,851004,1097800,1948804
2290,Greece,GRC,2000,859512,1110688,1970200
2291,Greece,GRC,2001,861579,1112896,1974475
2292,Greece,GRC,2002,858424,1107025,1965449
2293,Greece,GRC,2003,852558,1097502,1950060
2294,Greece,GRC,2004,846713,1088949,1935662
2295,Greece,GRC,2005,843294,1085184,1928478
2296,Greece,GRC,2006,841474,1085074,1926548
2297,Greece,GRC,2007,839256,1084726,1923982
2298,Greece,GRC,2008,837007,1084247,1921254
2299,Greece,GRC,2009,834333,1083860,1918193
2300,Greece,GRC,2010,830498,1081932,1912430
2301,Greece,GRC,2011,820987,1071053,1892040
2302,Greece,GRC,2012,804218,1048503,1852721
2303,Greece,GRC,2013,785258,1022131,1807389
2304,Greece,GRC,2014,768729,999601,1768330
2305,Greece,GRC,2015,757779,986643,1744422
2306,Greece,GRC,2016,754279,982560,1736839
2307,Greece,GRC,2017,753617,981941,1735558
2308,Greece,GRC,2018,753088,984230,1737318
2309,Greece,GRC,2019,753975,988505,1742480
2310,Greenland,GRL,1990,4930,4788,9718
2311,Greenland,GRL,1991,4893,4801,9694
2312,Greenland,GRL,1992,4836,4782,9618
2313,Greenland,GRL,1993,4797,4762,9559
2314,Greenland,GRL,1994,4793,4762,9555
2315,Greenland,GRL,1995,4798,4775,9573
2316,Greenland,GRL,1996,4803,4777,9580
2317,Greenland,GRL,1997,4794,4781,9575
2318,Greenland,GRL,1998,4785,4784,9569
2319,Greenland,GRL,1999,4786,4775,9561
2320,Greenland,GRL,2000,4795,4774,9569
2321,Greenland,GRL,2001,4809,4793,9602
2322,Greenland,GRL,2002,4829,4817,9646
2323,Greenland,GRL,2003,4846,4839,9685
2324,Greenland,GRL,2004,4858,4869,9727
2325,Greenland,GRL,2005,4854,4898,9752
2326,Greenland,GRL,2006,4831,4909,9740
2327,Greenland,GRL,2007,4820,4893,9713
2328,Greenland,GRL,2008,4820,4879,9699
2329,Greenland,GRL,2009,4829,4858,9687
2330,Greenland,GRL,2010,4840,4875,9715
2331,Greenland,GRL,2011,4835,4900,9735
2332,Greenland,GRL,2012,4821,4906,9727
2333,Greenland,GRL,2013,4783,4894,9677
2334,Greenland,GRL,2014,4739,4876,9615
2335,Greenland,GRL,2015,4710,4859,9569
2336,Greenland,GRL,2016,4699,4839,9538
2337,Greenland,GRL,2017,4690,4834,9524
2338,Greenland,GRL,2018,4662,4812,9474
2339,Greenland,GRL,2019,4624,4759,9383
2340,Grenada,GRD,1990,5744,5608,11352
2341,Grenada,GRD,1991,5785,5626,11411
2342,Grenada,GRD,1992,5859,5689,11548
2343,Grenada,GRD,1993,5963,5787,11750
2344,Grenada,GRD,1994,6095,5917,12012
2345,Grenada,GRD,1995,6249,6075,12324
2346,Grenada,GRD,1996,6417,6257,12674
2347,Grenada,GRD,1997,6599,6459,13058
2348,Grenada,GRD,1998,6790,6669,13459
2349,Grenada,GRD,1999,6974,6872,13846
2350,Grenada,GRD,2000,7146,7065,14211
2351,Grenada,GRD,2001,7294,7225,14519
2352,Grenada,GRD,2002,7418,7346,14764
2353,Grenada,GRD,2003,7514,7430,14944
2354,Grenada,GRD,2004,7580,7484,15064
2355,Grenada,GRD,2005,7625,7511,15136
2356,Grenada,GRD,2006,7648,7512,15160
2357,Grenada,GRD,2007,7654,7497,15151
2358,Grenada,GRD,2008,7651,7470,15121
2359,Grenada,GRD,2009,7645,7434,15079
2360,Grenada,GRD,2010,7634,7402,15036
2361,Grenada,GRD,2011,7631,7376,15007
2362,Grenada,GRD,2012,7629,7357,14986
2363,Grenada,GRD,2013,7632,7343,14975
2364,Grenada,GRD,2014,7630,7331,14961
2365,Grenada,GRD,2015,7624,7318,14942
2366,Grenada,GRD,2016,7608,7302,14910
2367,Grenada,GRD,2017,7585,7287,14872
2368,Grenada,GRD,2018,7571,7280,14851
2369,Grenada,GRD,2019,7554,7282,14836
2370,Guam,GUM,1990,7748,6827,14575
2371,Guam,GUM,1991,7891,6983,14874
2372,Guam,GUM,1992,8011,7147,15158
2373,Guam,GUM,1993,8115,7315,15430
2374,Guam,GUM,1994,8201,7488,15689
2375,Guam,GUM,1995,8274,7663,15937
2376,Guam,GUM,1996,8335,7843,16178
2377,Guam,GUM,1997,8384,8011,16395
2378,Guam,GUM,1998,8427,8171,16598
2379,Guam,GUM,1999,8478,8324,16802
2380,Guam,GUM,2000,8528,8458,16986
2381,Guam,GUM,2001,8583,8570,17153
2382,Guam,GUM,2002,8642,8655,17297
2383,Guam,GUM,2003,8706,8727,17433
2384,Guam,GUM,2004,8768,8786,17554
2385,Guam,GUM,2005,8825,8842,17667
2386,Guam,GUM,2006,8887,8896,17783
2387,Guam,GUM,2007,8949,8949,17898
2388,Guam,GUM,2008,9011,8999,18010
2389,Guam,GUM,2009,9073,9046,18119
2390,Guam,GUM,2010,9128,9082,18210
2391,Guam,GUM,2011,9184,9121,18305
2392,Guam,GUM,2012,9240,9159,18399
2393,Guam,GUM,2013,9295,9199,18494
2394,Guam,GUM,2014,9351,9240,18591
2395,Guam,GUM,2015,9404,9278,18682
2396,Guam,GUM,2016,9446,9317,18763
2397,Guam,GUM,2017,9486,9355,18841
2398,Guam,GUM,2018,9538,9412,18950
2399,Guam,GUM,2019,9594,9479,19073
2400,Guatemala,GTM,1990,421487,462785,884272
2401,Guatemala,GTM,1991,433120,478325,911445
2402,Guatemala,GTM,1992,445483,494765,940248
2403,Guatemala,GTM,1993,458520,512413,970933
2404,Guatemala,GTM,1994,472415,531083,1003498
2405,Guatemala,GTM,1995,487516,551493,1039009
2406,Guatemala,GTM,1996,504103,573827,1077930
2407,Guatemala,GTM,1997,521877,598308,1120185
2408,Guatemala,GTM,1998,540240,624202,1164442
2409,Guatemala,GTM,1999,559680,650990,1210670
2410,Guatemala,GTM,2000,580246,677879,1258125
2411,Guatemala,GTM,2001,601450,704950,1306400
2412,Guatemala,GTM,2002,622796,733151,1355947
2413,Guatemala,GTM,2003,644608,761713,1406321
2414,Guatemala,GTM,2004,666231,790939,1457170
2415,Guatemala,GTM,2005,687952,819960,1507912
2416,Guatemala,GTM,2006,709196,848239,1557435
2417,Guatemala,GTM,2007,730590,875787,1606377
2418,Guatemala,GTM,2008,751427,902592,1654019
2419,Guatemala,GTM,2009,772119,929402,1701521
2420,Guatemala,GTM,2010,793141,956199,1749340
2421,Guatemala,GTM,2011,814697,982530,1797227
2422,Guatemala,GTM,2012,835790,1008056,1843846
2423,Guatemala,GTM,2013,857645,1033167,1890812
2424,Guatemala,GTM,2014,879154,1059257,1938411
2425,Guatemala,GTM,2015,900517,1087260,1987777
2426,Guatemala,GTM,2016,923356,1117648,2041004
2427,Guatemala,GTM,2017,945993,1147669,2093662
2428,Guatemala,GTM,2018,966716,1175219,2141935
2429,Guatemala,GTM,2019,986383,1200157,2186540
2430,Guinea,GIN,1990,283984,325102,609086
2431,Guinea,GIN,1991,295821,337538,633359
2432,Guinea,GIN,1992,304953,347696,652649
2433,Guinea,GIN,1993,314965,358682,673647
2434,Guinea,GIN,1994,326888,371437,698325
2435,Guinea,GIN,1995,335090,381415,716505
2436,Guinea,GIN,1996,342895,390892,733787
2437,Guinea,GIN,1997,355636,404830,760466
2438,Guinea,GIN,1998,364440,415481,779921
2439,Guinea,GIN,1999,367426,421155,788581
2440,Guinea,GIN,2000,370373,426633,797006
2441,Guinea,GIN,2001,376678,435116,811794
2442,Guinea,GIN,2002,386028,445955,831983
2443,Guinea,GIN,2003,394559,456090,850649
2444,Guinea,GIN,2004,402446,465579,868025
2445,Guinea,GIN,2005,411089,475923,887012
2446,Guinea,GIN,2006,420326,487100,907426
2447,Guinea,GIN,2007,430466,498875,929341
2448,Guinea,GIN,2008,441657,511335,952992
2449,Guinea,GIN,2009,453366,524574,977940
2450,Guinea,GIN,2010,465322,538060,1003382
2451,Guinea,GIN,2011,477603,551928,1029531
2452,Guinea,GIN,2012,490197,565697,1055894
2453,Guinea,GIN,2013,503069,580018,1083087
2454,Guinea,GIN,2014,516234,594481,1110715
2455,Guinea,GIN,2015,529575,609453,1139028
2456,Guinea,GIN,2016,542819,625580,1168399
2457,Guinea,GIN,2017,557499,642099,1199598
2458,Guinea,GIN,2018,573592,659270,1232862
2459,Guinea,GIN,2019,591015,676517,1267532
2460,Guinea-Bissau,GNB,1990,45568,51838,97406
2461,Guinea-Bissau,GNB,1991,46641,52875,99516
2462,Guinea-Bissau,GNB,1992,47719,53949,101668
2463,Guinea-Bissau,GNB,1993,48848,55111,103959
2464,Guinea-Bissau,GNB,1994,50007,56304,106311
2465,Guinea-Bissau,GNB,1995,51217,57569,108786
2466,Guinea-Bissau,GNB,1996,52479,58905,111384
2467,Guinea-Bissau,GNB,1997,53719,60288,114007
2468,Guinea-Bissau,GNB,1998,54997,61756,116753
2469,Guinea-Bissau,GNB,1999,56263,63202,119465
2470,Guinea-Bissau,GNB,2000,57575,64717,122292
2471,Guinea-Bissau,GNB,2001,59003,66290,125293
2472,Guinea-Bissau,GNB,2002,60464,67922,128386
2473,Guinea-Bissau,GNB,2003,62008,69645,131653
2474,Guinea-Bissau,GNB,2004,63539,71398,134937
2475,Guinea-Bissau,GNB,2005,65097,73193,138290
2476,Guinea-Bissau,GNB,2006,66686,74995,141681
2477,Guinea-Bissau,GNB,2007,68301,76863,145164
2478,Guinea-Bissau,GNB,2008,70008,78784,148792
2479,Guinea-Bissau,GNB,2009,71744,80762,152506
2480,Guinea-Bissau,GNB,2010,73455,82742,156197
2481,Guinea-Bissau,GNB,2011,75255,84775,160030
2482,Guinea-Bissau,GNB,2012,77058,86830,163888
2483,Guinea-Bissau,GNB,2013,78884,88895,167779
2484,Guinea-Bissau,GNB,2014,80777,91034,171811
2485,Guinea-Bissau,GNB,2015,82687,93287,175974
2486,Guinea-Bissau,GNB,2016,84618,95665,180283
2487,Guinea-Bissau,GNB,2017,86641,98180,184821
2488,Guinea-Bissau,GNB,2018,88777,100563,189340
2489,Guinea-Bissau,GNB,2019,91088,102980,194068
2490,Guyana,GUY,1990,56076,56825,112901
2491,Guyana,GUY,1991,55935,56808,112743
2492,Guyana,GUY,1992,55842,56801,112643
2493,Guyana,GUY,1993,55831,56828,112659
2494,Guyana,GUY,1994,55872,56803,112675
2495,Guyana,GUY,1995,55955,56786,112741
2496,Guyana,GUY,1996,56057,56810,112867
2497,Guyana,GUY,1997,56205,56905,113110
2498,Guyana,GUY,1998,56413,57057,113470
2499,Guyana,GUY,1999,56644,57234,113878
2500,Guyana,GUY,2000,56944,57381,114325
2501,Guyana,GUY,2001,57278,57500,114778
2502,Guyana,GUY,2002,57608,57667,115275
2503,Guyana,GUY,2003,57935,57832,115767
2504,Guyana,GUY,2004,58153,58005,116158
2505,Guyana,GUY,2005,58228,58144,116372
2506,Guyana,GUY,2006,58217,58301,116518
2507,Guyana,GUY,2007,58095,58483,116578
2508,Guyana,GUY,2008,57947,58663,116610
2509,Guyana,GUY,2009,57709,58832,116541
2510,Guyana,GUY,2010,57517,58981,116498
2511,Guyana,GUY,2011,57270,59093,116363
2512,Guyana,GUY,2012,57016,59175,116191
2513,Guyana,GUY,2013,56731,59212,115943
2514,Guyana,GUY,2014,56460,59274,115734
2515,Guyana,GUY,2015,56172,59366,115538
2516,Guyana,GUY,2016,56628,60096,116724
2517,Guyana,GUY,2017,57897,61461,119358
2518,Guyana,GUY,2018,58456,62074,120530
2519,Guyana,GUY,2019,58235,61912,120147
2520,Haiti,HTI,1990,425705,439988,865693
2521,Haiti,HTI,1991,437927,452595,890522
2522,Haiti,HTI,1992,450850,465791,916641
2523,Haiti,HTI,1993,464027,479305,943332
2524,Haiti,HTI,1994,477606,493352,970958
2525,Haiti,HTI,1995,491192,507989,999181
2526,Haiti,HTI,1996,505292,523064,1028356
2527,Haiti,HTI,1997,519365,538535,1057900
2528,Haiti,HTI,1998,533759,554499,1088258
2529,Haiti,HTI,1999,548462,570958,1119420
2530,Haiti,HTI,2000,563489,587844,1151333
2531,Haiti,HTI,2001,578911,604647,1183558
2532,Haiti,HTI,2002,594540,621422,1215962
2533,Haiti,HTI,2003,610335,638369,1248704
2534,Haiti,HTI,2004,625968,655472,1281440
2535,Haiti,HTI,2005,641844,672371,1314215
2536,Haiti,HTI,2006,658204,689806,1348010
2537,Haiti,HTI,2007,674708,707877,1382585
2538,Haiti,HTI,2008,691697,726326,1418023
2539,Haiti,HTI,2009,709201,745204,1454405
2540,Haiti,HTI,2010,716774,757992,1474766
2541,Haiti,HTI,2011,724539,770517,1495056
2542,Haiti,HTI,2012,742519,789838,1532357
2543,Haiti,HTI,2013,761142,809405,1570547
2544,Haiti,HTI,2014,780222,829630,1609852
2545,Haiti,HTI,2015,798388,849597,1647985
2546,Haiti,HTI,2016,816055,870362,1686417
2547,Haiti,HTI,2017,833947,891069,1725016
2548,Haiti,HTI,2018,852912,911511,1764423
2549,Haiti,HTI,2019,872704,931230,1803934
2550,Honduras,HND,1990,243091,256916,500007
2551,Honduras,HND,1991,251050,265579,516629
2552,Honduras,HND,1992,259097,274281,533378
2553,Honduras,HND,1993,267298,283375,550673
2554,Honduras,HND,1994,275584,292609,568193
2555,Honduras,HND,1995,283967,302179,586146
2556,Honduras,HND,1996,292401,311796,604197
2557,Honduras,HND,1997,300980,321859,622839
2558,Honduras,HND,1998,309127,331973,641100
2559,Honduras,HND,1999,317542,342371,659913
2560,Honduras,HND,2000,326767,353462,680229
2561,Honduras,HND,2001,336351,365203,701554
2562,Honduras,HND,2002,346347,377637,723984
2563,Honduras,HND,2003,356780,390591,747371
2564,Honduras,HND,2004,367400,403950,771350
2565,Honduras,HND,2005,378047,417557,795604
2566,Honduras,HND,2006,388781,431128,819909
2567,Honduras,HND,2007,399930,445370,845300
2568,Honduras,HND,2008,411353,459899,871252
2569,Honduras,HND,2009,422952,474427,897379
2570,Honduras,HND,2010,434394,489444,923838
2571,Honduras,HND,2011,445693,504647,950340
2572,Honduras,HND,2012,456888,519793,976681
2573,Honduras,HND,2013,467861,535277,1003138
2574,Honduras,HND,2014,478779,550572,1029351
2575,Honduras,HND,2015,489640,565930,1055570
2576,Honduras,HND,2016,500784,581324,1082108
2577,Honduras,HND,2017,512327,596665,1108992
2578,Honduras,HND,2018,523602,611253,1134855
2579,Honduras,HND,2019,534961,625268,1160229
2580,Hungary,HUN,1990,540172,715067,1255239
2581,Hungary,HUN,1991,539664,715290,1254954
2582,Hungary,HUN,1992,538392,715016,1253408
2583,Hungary,HUN,1993,536664,714209,1250873
2584,Hungary,HUN,1994,534862,713365,1248227
2585,Hungary,HUN,1995,533216,712502,1245718
2586,Hungary,HUN,1996,531356,710931,1242287
2587,Hungary,HUN,1997,529399,707893,1237292
2588,Hungary,HUN,1998,526893,703926,1230819
2589,Hungary,HUN,1999,524323,700135,1224458
2590,Hungary,HUN,2000,522167,697227,1219394
2591,Hungary,HUN,2001,520365,695024,1215389
2592,Hungary,HUN,2002,518544,692510,1211054
2593,Hungary,HUN,2003,516241,689762,1206003
2594,Hungary,HUN,2004,514103,687056,1201159
2595,Hungary,HUN,2005,511773,684522,1196295
2596,Hungary,HUN,2006,509303,682161,1191464
2597,Hungary,HUN,2007,506497,679831,1186328
2598,Hungary,HUN,2008,503802,677538,1181340
2599,Hungary,HUN,2009,501304,675352,1176656
2600,Hungary,HUN,2010,499155,673252,1172407
2601,Hungary,HUN,2011,497190,671608,1168798
2602,Hungary,HUN,2012,495245,669910,1165155
2603,Hungary,HUN,2013,493259,668666,1161925
2604,Hungary,HUN,2014,491360,667406,1158766
2605,Hungary,HUN,2015,489615,665580,1155195
2606,Hungary,HUN,2016,488606,663190,1151796
2607,Hungary,HUN,2017,487422,660758,1148180
2608,Hungary,HUN,2018,485295,658432,1143727
2609,Hungary,HUN,2019,482485,655844,1138329
2610,Iceland,ISL,1990,16211,18867,35078
2611,Iceland,ISL,1991,16369,19067,35436
2612,Iceland,ISL,1992,16524,19254,35778
2613,Iceland,ISL,1993,16678,19429,36107
2614,Iceland,ISL,1994,16823,19596,36419
2615,Iceland,ISL,1995,16933,19737,36670
2616,Iceland,ISL,1996,17030,19879,36909
2617,Iceland,ISL,1997,17146,20029,37175
2618,Iceland,ISL,1998,17315,20221,37536
2619,Iceland,ISL,1999,17526,20470,37996
2620,Iceland,ISL,2000,17739,20743,38482
2621,Iceland,ISL,2001,17965,21017,38982
2622,Iceland,ISL,2002,18154,21236,39390
2623,Iceland,ISL,2003,18329,21419,39748
2624,Iceland,ISL,2004,18549,21621,40170
2625,Iceland,ISL,2005,18868,21852,40720
2626,Iceland,ISL,2006,19316,22133,41449
2627,Iceland,ISL,2007,19802,22446,42248
2628,Iceland,ISL,2008,20164,22775,42939
2629,Iceland,ISL,2009,20308,23043,43351
2630,Iceland,ISL,2010,20266,23227,43493
2631,Iceland,ISL,2011,20215,23380,43595
2632,Iceland,ISL,2012,20234,23555,43789
2633,Iceland,ISL,2013,20337,23770,44107
2634,Iceland,ISL,2014,20553,24045,44598
2635,Iceland,ISL,2015,20852,24342,45194
2636,Iceland,ISL,2016,21194,24606,45800
2637,Iceland,ISL,2017,21541,24856,46397
2638,Iceland,ISL,2018,21834,25133,46967
2639,Iceland,ISL,2019,22087,25434,47521
2640,India,IND,1990,57528640,56258335,113786975
2641,India,IND,1991,58997525,57956521,116954046
2642,India,IND,1992,60438534,59616654,120055188
2643,India,IND,1993,61852184,61203467,123055651
2644,India,IND,1994,63216199,62698693,125914892
2645,India,IND,1995,64503094,64042308,128545402
2646,India,IND,1996,65602722,65184323,130787045
2647,India,IND,1997,66487999,66154192,132642191
2648,India,IND,1998,67296503,67080280,134376783
2649,India,IND,1999,68191273,68100604,136291877
2650,India,IND,2000,69333138,69385777,138718915
2651,India,IND,2001,70725924,70956678,141682602
2652,India,IND,2002,72246852,72697667,144944519
2653,India,IND,2003,73837464,74545934,148383398
2654,India,IND,2004,75422763,76419007,151841770
2655,India,IND,2005,76921674,78208397,155130071
2656,India,IND,2006,78157512,79571787,157729299
2657,India,IND,2007,79141596,80426129,159567725
2658,India,IND,2008,80003294,81050959,161054253
2659,India,IND,2009,80917947,81775904,162693851
2660,India,IND,2010,82082111,82950928,165033039
2661,India,IND,2011,83453862,84522928,167976790
2662,India,IND,2012,84834998,86151548,170986546
2663,India,IND,2013,86210181,87789918,174000099
2664,India,IND,2014,87553895,89381541,176935436
2665,India,IND,2015,88844430,90851972,179696402
2666,India,IND,2016,90101893,92203805,182305698
2667,India,IND,2017,91301411,93510534,184811945
2668,India,IND,2018,92285863,94446968,186732831
2669,India,IND,2019,93047095,94916614,187963709
2670,Indonesia,IDN,1990,9072718,10129837,19202555
2671,Indonesia,IDN,1991,9205672,10277268,19482940
2672,Indonesia,IDN,1992,9338778,10425623,19764401
2673,Indonesia,IDN,1993,9470027,10575356,20045383
2674,Indonesia,IDN,1994,9601918,10731051,20332969
2675,Indonesia,IDN,1995,9735846,10890009,20625855
2676,Indonesia,IDN,1996,9869326,11053902,20923228
2677,Indonesia,IDN,1997,9999123,11220621,21219744
2678,Indonesia,IDN,1998,10128284,11386087,21514371
2679,Indonesia,IDN,1999,10262079,11552492,21814571
2680,Indonesia,IDN,2000,10403253,11715638,22118891
2681,Indonesia,IDN,2001,10552396,11884053,22436449
2682,Indonesia,IDN,2002,10706009,12054131,22760140
2683,Indonesia,IDN,2003,10861008,12225959,23086967
2684,Indonesia,IDN,2004,11012243,12390836,23403079
2685,Indonesia,IDN,2005,11158500,12546632,23705132
2686,Indonesia,IDN,2006,11305799,12688703,23994502
2687,Indonesia,IDN,2007,11446128,12809831,24255959
2688,Indonesia,IDN,2008,11583603,12923826,24507429
2689,Indonesia,IDN,2009,11718366,13040199,24758565
2690,Indonesia,IDN,2010,11854400,13163192,25017592
2691,Indonesia,IDN,2011,11988609,13300894,25289503
2692,Indonesia,IDN,2012,12122506,13445669,25568175
2693,Indonesia,IDN,2013,12251705,13597011,25848716
2694,Indonesia,IDN,2014,12376869,13745732,26122601
2695,Indonesia,IDN,2015,12504589,13894248,26398837
2696,Indonesia,IDN,2016,12620170,14046744,26666914
2697,Indonesia,IDN,2017,12731254,14197629,26928883
2698,Indonesia,IDN,2018,12852426,14361929,27214355
2699,Indonesia,IDN,2019,12984840,14551015,27535855
2700,Iran,IRN,1990,4980689,5017127,9997816
2701,Iran,IRN,1991,5023343,5104425,10127768
2702,Iran,IRN,1992,5017701,5149627,10167328
2703,Iran,IRN,1993,5092248,5254100,10346348
2704,Iran,IRN,1994,5210599,5392142,10602741
2705,Iran,IRN,1995,5331494,5530288,10861782
2706,Iran,IRN,1996,5477446,5672820,11150266
2707,Iran,IRN,1997,5660501,5823002,11483503
2708,Iran,IRN,1998,5862888,5982821,11845709
2709,Iran,IRN,1999,6051393,6142003,12193396
2710,Iran,IRN,2000,6190999,6289943,12480942
2711,Iran,IRN,2001,6280308,6427317,12707625
2712,Iran,IRN,2002,6361526,6574944,12936470
2713,Iran,IRN,2003,6446460,6734826,13181286
2714,Iran,IRN,2004,6511503,6880567,13392070
2715,Iran,IRN,2005,6568258,7012517,13580775
2716,Iran,IRN,2006,6642253,7145998,13788251
2717,Iran,IRN,2007,6735784,7290525,14026309
2718,Iran,IRN,2008,6838304,7440353,14278657
2719,Iran,IRN,2009,6923950,7576591,14500541
2720,Iran,IRN,2010,6981172,7690629,14671801
2721,Iran,IRN,2011,7027567,7797663,14825230
2722,Iran,IRN,2012,7087769,7911115,14998884
2723,Iran,IRN,2013,7156192,8022448,15178640
2724,Iran,IRN,2014,7223806,8121390,15345196
2725,Iran,IRN,2015,7291916,8201128,15493044
2726,Iran,IRN,2016,7316608,8220066,15536674
2727,Iran,IRN,2017,7338522,8230838,15569360
2728,Iran,IRN,2018,7378588,8279663,15658251
2729,Iran,IRN,2019,7388632,8323329,15711961
2730,Iraq,IRQ,1990,1074426,1160440,2234866
2731,Iraq,IRQ,1991,1162972,1243884,2406856
2732,Iraq,IRQ,1992,1268840,1342411,2611251
2733,Iraq,IRQ,1993,1343886,1414457,2758343
2734,Iraq,IRQ,1994,1404362,1475344,2879706
2735,Iraq,IRQ,1995,1458679,1532518,2991197
2736,Iraq,IRQ,1996,1511051,1586992,3098043
2737,Iraq,IRQ,1997,1565005,1637859,3202864
2738,Iraq,IRQ,1998,1619726,1688317,3308043
2739,Iraq,IRQ,1999,1676263,1741591,3417854
2740,Iraq,IRQ,2000,1736082,1802101,3538183
2741,Iraq,IRQ,2001,1795886,1869172,3665058
2742,Iraq,IRQ,2002,1845003,1935329,3780332
2743,Iraq,IRQ,2003,1893595,2005305,3898900
2744,Iraq,IRQ,2004,1930370,2064303,3994673
2745,Iraq,IRQ,2005,1928097,2088301,4016398
2746,Iraq,IRQ,2006,1938616,2117460,4056076
2747,Iraq,IRQ,2007,1995484,2186534,4182018
2748,Iraq,IRQ,2008,2060698,2263813,4324511
2749,Iraq,IRQ,2009,2119482,2334874,4454356
2750,Iraq,IRQ,2010,2193185,2418793,4611978
2751,Iraq,IRQ,2011,2291897,2527956,4819853
2752,Iraq,IRQ,2012,2395631,2646525,5042156
2753,Iraq,IRQ,2013,2481287,2750934,5232221
2754,Iraq,IRQ,2014,2549078,2839334,5388412
2755,Iraq,IRQ,2015,2602843,2910981,5513824
2756,Iraq,IRQ,2016,2648321,2966361,5614682
2757,Iraq,IRQ,2017,2695499,3024754,5720253
2758,Iraq,IRQ,2018,2747156,3094595,5841751
2759,Iraq,IRQ,2019,2799324,3166814,5966138
2760,Ireland,IRL,1990,265872,307770,573642
2761,Ireland,IRL,1991,267115,309709,576824
2762,Ireland,IRL,1992,268617,312162,580779
2763,Ireland,IRL,1993,270478,314951,585429
2764,Ireland,IRL,1994,272512,317860,590372
2765,Ireland,IRL,1995,274812,321203,596015
2766,Ireland,IRL,1996,276835,324642,601477
2767,Ireland,IRL,1997,278496,327764,606260
2768,Ireland,IRL,1998,279973,331079,611052
2769,Ireland,IRL,1999,281901,334794,616695
2770,Ireland,IRL,2000,284916,339329,624245
2771,Ireland,IRL,2001,289153,344573,633726
2772,Ireland,IRL,2002,293976,350328,644304
2773,Ireland,IRL,2003,299409,356342,655751
2774,Ireland,IRL,2004,305314,362748,668062
2775,Ireland,IRL,2005,311261,369601,680862
2776,Ireland,IRL,2006,317897,378057,695954
2777,Ireland,IRL,2007,325423,388695,714118
2778,Ireland,IRL,2008,332692,399841,732533
2779,Ireland,IRL,2009,339044,410102,749146
2780,Ireland,IRL,2010,343496,417652,761148
2781,Ireland,IRL,2011,346605,422837,769442
2782,Ireland,IRL,2012,349056,426606,775662
2783,Ireland,IRL,2013,351418,429483,780901
2784,Ireland,IRL,2014,353724,432106,785830
2785,Ireland,IRL,2015,356133,434803,790936
2786,Ireland,IRL,2016,360060,439739,799799
2787,Ireland,IRL,2017,363826,444503,808329
2788,Ireland,IRL,2018,365000,445806,810806
2789,Ireland,IRL,2019,364266,444858,809124
2790,Israel,ISR,1990,319073,351009,670082
2791,Israel,ISR,1991,329088,364202,693290
2792,Israel,ISR,1992,339195,377357,716552
2793,Israel,ISR,1993,349461,389979,739440
2794,Israel,ISR,1994,359555,402129,761684
2795,Israel,ISR,1995,369309,413467,782776
2796,Israel,ISR,1996,377583,422389,799972
2797,Israel,ISR,1997,384253,428965,813218
2798,Israel,ISR,1998,390182,434194,824376
2799,Israel,ISR,1999,396326,439815,836141
2800,Israel,ISR,2000,403889,447490,851379
2801,Israel,ISR,2001,412531,456810,869341
2802,Israel,ISR,2002,420467,465665,886132
2803,Israel,ISR,2003,428381,474735,903116
2804,Israel,ISR,2004,436438,483631,920069
2805,Israel,ISR,2005,444821,492997,937818
2806,Israel,ISR,2006,455197,505500,960697
2807,Israel,ISR,2007,468159,521973,990132
2808,Israel,ISR,2008,481950,540204,1022154
2809,Israel,ISR,2009,495202,557112,1052314
2810,Israel,ISR,2010,506144,570035,1076179
2811,Israel,ISR,2011,515114,578516,1093630
2812,Israel,ISR,2012,523108,584760,1107868
2813,Israel,ISR,2013,531433,590331,1121764
2814,Israel,ISR,2014,539889,596496,1136385
2815,Israel,ISR,2015,549045,604624,1153669
2816,Israel,ISR,2016,560537,613109,1173646
2817,Israel,ISR,2017,572537,622081,1194618
2818,Israel,ISR,2018,583341,633420,1216761
2819,Israel,ISR,2019,594591,645676,1240267
2820,Italy,ITA,1990,3720315,5143612,8863927
2821,Italy,ITA,1991,3682804,5103975,8786779
2822,Italy,ITA,1992,3643726,5065029,8708755
2823,Italy,ITA,1993,3605140,5029650,8634790
2824,Italy,ITA,1994,3567916,4999564,8567480
2825,Italy,ITA,1995,3532086,4977495,8509581
2826,Italy,ITA,1996,3494474,4961633,8456107
2827,Italy,ITA,1997,3454548,4949702,8404250
2828,Italy,ITA,1998,3418041,4942439,8360480
2829,Italy,ITA,1999,3392244,4941095,8333339
2830,Italy,ITA,2000,3384480,4946258,8330738
2831,Italy,ITA,2001,3390194,4954433,8344627
2832,Italy,ITA,2002,3401103,4963370,8364473
2833,Italy,ITA,2003,3416873,4975612,8392485
2834,Italy,ITA,2004,3438484,4995498,8433982
2835,Italy,ITA,2005,3461974,5020526,8482500
2836,Italy,ITA,2006,3499698,5050866,8550564
2837,Italy,ITA,2007,3559169,5089474,8648643
2838,Italy,ITA,2008,3626529,5133253,8759782
2839,Italy,ITA,2009,3686711,5177213,8863924
2840,Italy,ITA,2010,3723561,5215951,8939512
2841,Italy,ITA,2011,3743503,5246191,8989694
2842,Italy,ITA,2012,3761419,5266943,9028362
2843,Italy,ITA,2013,3776571,5279074,9055645
2844,Italy,ITA,2014,3788101,5283608,9071709
2845,Italy,ITA,2015,3794331,5282610,9076941
2846,Italy,ITA,2016,3795389,5272375,9067764
2847,Italy,ITA,2017,3795670,5260822,9056492
2848,Italy,ITA,2018,3798528,5257645,9056173
2849,Italy,ITA,2019,3804488,5261337,9065825
2850,Jamaica,JAM,1990,153995,153975,307970
2851,Jamaica,JAM,1991,154957,154775,309732
2852,Jamaica,JAM,1992,156285,156018,312303
2853,Jamaica,JAM,1993,157785,157470,315255
2854,Jamaica,JAM,1994,159567,159310,318877
2855,Jamaica,JAM,1995,161503,161414,322917
2856,Jamaica,JAM,1996,163609,163835,327444
2857,Jamaica,JAM,1997,165824,166334,332158
2858,Jamaica,JAM,1998,168057,168902,336959
2859,Jamaica,JAM,1999,170297,171369,341666
2860,Jamaica,JAM,2000,172526,173657,346183
2861,Jamaica,JAM,2001,174654,175741,350395
2862,Jamaica,JAM,2002,176808,177674,354482
2863,Jamaica,JAM,2003,178787,179428,358215
2864,Jamaica,JAM,2004,180678,181052,361730
2865,Jamaica,JAM,2005,182349,182498,364847
2866,Jamaica,JAM,2006,183882,183878,367760
2867,Jamaica,JAM,2007,185195,185029,370224
2868,Jamaica,JAM,2008,186221,186130,372351
2869,Jamaica,JAM,2009,187048,187118,374166
2870,Jamaica,JAM,2010,187859,188251,376110
2871,Jamaica,JAM,2011,188697,189589,378286
2872,Jamaica,JAM,2012,189524,191269,380793
2873,Jamaica,JAM,2013,190478,193006,383484
2874,Jamaica,JAM,2014,191308,194558,385866
2875,Jamaica,JAM,2015,191935,195667,387602
2876,Jamaica,JAM,2016,192249,196517,388766
2877,Jamaica,JAM,2017,192423,197271,389694
2878,Jamaica,JAM,2018,192994,198779,391773
2879,Jamaica,JAM,2019,193793,200961,394754
2880,Japan,JPN,1990,6829834,6398034,13227868
2881,Japan,JPN,1991,6826539,6390865,13217404
2882,Japan,JPN,1992,6822952,6391944,13214896
2883,Japan,JPN,1993,6822227,6401736,13223963
2884,Japan,JPN,1994,6822809,6417316,13240125
2885,Japan,JPN,1995,6823723,6435928,13259651
2886,Japan,JPN,1996,6832908,6473460,13306368
2887,Japan,JPN,1997,6853764,6535720,13389484
2888,Japan,JPN,1998,6878527,6608258,13486785
2889,Japan,JPN,1999,6899995,6675310,13575305
2890,Japan,JPN,2000,6909720,6720638,13630358
2891,Japan,JPN,2001,6913814,6750271,13664085
2892,Japan,JPN,2002,6917618,6779748,13697366
2893,Japan,JPN,2003,6919835,6806036,13725871
2894,Japan,JPN,2004,6916773,6825910,13742683
2895,Japan,JPN,2005,6906950,6836194,13743144
2896,Japan,JPN,2006,6875278,6824016,13699294
2897,Japan,JPN,2007,6816163,6787263,13603426
2898,Japan,JPN,2008,6747175,6739251,13486426
2899,Japan,JPN,2009,6685186,6688873,13374059
2900,Japan,JPN,2010,6644702,6647503,13292205
2901,Japan,JPN,2011,6621510,6599748,13221258
2902,Japan,JPN,2012,6598512,6532840,13131352
2903,Japan,JPN,2013,6576918,6461299,13038217
2904,Japan,JPN,2014,6554413,6398946,12953359
2905,Japan,JPN,2015,6530981,6356770,12887751
2906,Japan,JPN,2016,6503556,6332524,12836080
2907,Japan,JPN,2017,6473872,6312113,12785985
2908,Japan,JPN,2018,6444934,6287463,12732397
2909,Japan,JPN,2019,6413876,6256768,12670644
2910,Jordan,JOR,1990,253143,256944,510087
2911,Jordan,JOR,1991,264007,268856,532863
2912,Jordan,JOR,1992,274169,280446,554615
2913,Jordan,JOR,1993,283182,291186,574368
2914,Jordan,JOR,1994,291160,301073,592233
2915,Jordan,JOR,1995,297566,309797,607363
2916,Jordan,JOR,1996,302630,317349,619979
2917,Jordan,JOR,1997,307060,324146,631206
2918,Jordan,JOR,1998,311026,330653,641679
2919,Jordan,JOR,1999,315255,337241,652496
2920,Jordan,JOR,2000,319434,344093,663527
2921,Jordan,JOR,2001,324089,351570,675659
2922,Jordan,JOR,2002,329763,359725,689488
2923,Jordan,JOR,2003,337084,369305,706389
2924,Jordan,JOR,2004,355676,388101,743777
2925,Jordan,JOR,2005,386104,416658,802762
2926,Jordan,JOR,2006,410226,439332,849558
2927,Jordan,JOR,2007,426363,455067,881430
2928,Jordan,JOR,2008,444233,471754,915987
2929,Jordan,JOR,2009,465818,491728,957546
2930,Jordan,JOR,2010,488317,513516,1001833
2931,Jordan,JOR,2011,516888,540646,1057534
2932,Jordan,JOR,2012,557358,577214,1134572
2933,Jordan,JOR,2013,598115,614189,1212304
2934,Jordan,JOR,2014,634253,648077,1282330
2935,Jordan,JOR,2015,671484,683019,1354503
2936,Jordan,JOR,2016,707812,717435,1425247
2937,Jordan,JOR,2017,744012,752524,1496536
2938,Jordan,JOR,2018,782001,791280,1573281
2939,Jordan,JOR,2019,821327,833688,1655015
2940,Kazakhstan,KAZ,1990,763981,854650,1618631
2941,Kazakhstan,KAZ,1991,762490,853087,1615577
2942,Kazakhstan,KAZ,1992,759209,849544,1608753
2943,Kazakhstan,KAZ,1993,755032,844979,1600011
2944,Kazakhstan,KAZ,1994,750729,839794,1590523
2945,Kazakhstan,KAZ,1995,745750,835203,1580953
2946,Kazakhstan,KAZ,1996,742313,831633,1573946
2947,Kazakhstan,KAZ,1997,741342,830312,1571654
2948,Kazakhstan,KAZ,1998,742280,830877,1573157
2949,Kazakhstan,KAZ,1999,744365,832712,1577077
2950,Kazakhstan,KAZ,2000,746245,835512,1581757
2951,Kazakhstan,KAZ,2001,747285,838186,1585471
2952,Kazakhstan,KAZ,2002,748172,840975,1589147
2953,Kazakhstan,KAZ,2003,749452,844307,1593759
2954,Kazakhstan,KAZ,2004,751268,848614,1599882
2955,Kazakhstan,KAZ,2005,753947,853753,1607700
2956,Kazakhstan,KAZ,2006,757062,859209,1616271
2957,Kazakhstan,KAZ,2007,759464,865565,1625029
2958,Kazakhstan,KAZ,2008,762087,871554,1633641
2959,Kazakhstan,KAZ,2009,765798,877649,1643447
2960,Kazakhstan,KAZ,2010,770795,884458,1655253
2961,Kazakhstan,KAZ,2011,777045,892994,1670039
2962,Kazakhstan,KAZ,2012,783894,902697,1686591
2963,Kazakhstan,KAZ,2013,791528,912730,1704258
2964,Kazakhstan,KAZ,2014,800114,923774,1723888
2965,Kazakhstan,KAZ,2015,809827,934496,1744323
2966,Kazakhstan,KAZ,2016,820158,945069,1765227
2967,Kazakhstan,KAZ,2017,831118,956182,1787300
2968,Kazakhstan,KAZ,2018,843417,966884,1810301
2969,Kazakhstan,KAZ,2019,856237,977439,1833676
2970,Kenya,KEN,1990,1108780,1180083,2288863
2971,Kenya,KEN,1991,1148832,1221762,2370594
2972,Kenya,KEN,1992,1189929,1265275,2455204
2973,Kenya,KEN,1993,1231895,1310227,2542122
2974,Kenya,KEN,1994,1274553,1356407,2630960
2975,Kenya,KEN,1995,1317658,1403725,2721383
2976,Kenya,KEN,1996,1362551,1453000,2815551
2977,Kenya,KEN,1997,1409880,1504322,2914202
2978,Kenya,KEN,1998,1458744,1556676,3015420
2979,Kenya,KEN,1999,1507549,1609125,3116674
2980,Kenya,KEN,2000,1555044,1660604,3215648
2981,Kenya,KEN,2001,1602300,1710647,3312947
2982,Kenya,KEN,2002,1650840,1759636,3410476
2983,Kenya,KEN,2003,1700691,1808298,3508989
2984,Kenya,KEN,2004,1751578,1857040,3608618
2985,Kenya,KEN,2005,1803612,1907260,3710872
2986,Kenya,KEN,2006,1855900,1957994,3813894
2987,Kenya,KEN,2007,1908895,2008609,3917504
2988,Kenya,KEN,2008,1962732,2060302,4023034
2989,Kenya,KEN,2009,2018203,2114316,4132519
2990,Kenya,KEN,2010,2076039,2172300,4248339
2991,Kenya,KEN,2011,2135078,2233323,4368401
2992,Kenya,KEN,2012,2193821,2295670,4489491
2993,Kenya,KEN,2013,2252505,2359583,4612088
2994,Kenya,KEN,2014,2312719,2425619,4738338
2995,Kenya,KEN,2015,2374974,2494656,4869630
2996,Kenya,KEN,2016,2438093,2568477,5006570
2997,Kenya,KEN,2017,2502922,2644323,5147245
2998,Kenya,KEN,2018,2571398,2719190,5290588
2999,Kenya,KEN,2019,2642518,2793532,5436050
3000,Kiribati,KIR,1990,3984,4125,8109
3001,Kiribati,KIR,1991,4060,4204,8264
3002,Kiribati,KIR,1992,4131,4274,8405
3003,Kiribati,KIR,1993,4198,4340,8538
3004,Kiribati,KIR,1994,4263,4406,8669
3005,Kiribati,KIR,1995,4332,4476,8808
3006,Kiribati,KIR,1996,4406,4560,8966
3007,Kiribati,KIR,1997,4483,4648,9131
3008,Kiribati,KIR,1998,4567,4746,9313
3009,Kiribati,KIR,1999,4658,4846,9504
3010,Kiribati,KIR,2000,4753,4951,9704
3011,Kiribati,KIR,2001,4853,5054,9907
3012,Kiribati,KIR,2002,4958,5156,10114
3013,Kiribati,KIR,2003,5066,5258,10324
3014,Kiribati,KIR,2004,5177,5365,10542
3015,Kiribati,KIR,2005,5293,5482,10775
3016,Kiribati,KIR,2006,5414,5609,11023
3017,Kiribati,KIR,2007,5536,5742,11278
3018,Kiribati,KIR,2008,5658,5876,11534
3019,Kiribati,KIR,2009,5771,6004,11775
3020,Kiribati,KIR,2010,5872,6127,11999
3021,Kiribati,KIR,2011,5960,6234,12194
3022,Kiribati,KIR,2012,6041,6338,12379
3023,Kiribati,KIR,2013,6122,6434,12556
3024,Kiribati,KIR,2014,6194,6531,12725
3025,Kiribati,KIR,2015,6266,6627,12893
3026,Kiribati,KIR,2016,6328,6716,13044
3027,Kiribati,KIR,2017,6390,6814,13204
3028,Kiribati,KIR,2018,6466,6917,13383
3029,Kiribati,KIR,2019,6557,7029,13586
3030,Kuwait,KWT,1990,123928,101877,225805
3031,Kuwait,KWT,1991,122422,100394,222816
3032,Kuwait,KWT,1992,120725,98611,219336
3033,Kuwait,KWT,1993,118985,96759,215744
3034,Kuwait,KWT,1994,117484,94981,212465
3035,Kuwait,KWT,1995,119841,95845,215686
3036,Kuwait,KWT,1996,126422,99369,225791
3037,Kuwait,KWT,1997,131547,101900,233447
3038,Kuwait,KWT,1998,134711,103348,238059
3039,Kuwait,KWT,1999,138516,105371,243887
3040,Kuwait,KWT,2000,142938,108109,251047
3041,Kuwait,KWT,2001,147310,111161,258471
3042,Kuwait,KWT,2002,151695,114665,266360
3043,Kuwait,KWT,2003,157475,119485,276960
3044,Kuwait,KWT,2004,164995,125860,290855
3045,Kuwait,KWT,2005,173694,133660,307354
3046,Kuwait,KWT,2006,183271,142847,326118
3047,Kuwait,KWT,2007,192292,152341,344633
3048,Kuwait,KWT,2008,200496,162126,362622
3049,Kuwait,KWT,2009,209645,173322,382967
3050,Kuwait,KWT,2010,219767,186231,405998
3051,Kuwait,KWT,2011,230329,200260,430589
3052,Kuwait,KWT,2012,240972,214933,455905
3053,Kuwait,KWT,2013,251528,230091,481619
3054,Kuwait,KWT,2014,261973,245322,507295
3055,Kuwait,KWT,2015,272033,260507,532540
3056,Kuwait,KWT,2016,281556,275178,556734
3057,Kuwait,KWT,2017,290795,289828,580623
3058,Kuwait,KWT,2018,300337,305371,605708
3059,Kuwait,KWT,2019,309836,321718,631554
3060,Kyrgyzstan,KGZ,1990,217144,229498,446642
3061,Kyrgyzstan,KGZ,1991,221754,233354,455108
3062,Kyrgyzstan,KGZ,1992,226620,237108,463728
3063,Kyrgyzstan,KGZ,1993,231473,240995,472468
3064,Kyrgyzstan,KGZ,1994,236313,244780,481093
3065,Kyrgyzstan,KGZ,1995,241250,248733,489983
3066,Kyrgyzstan,KGZ,1996,246582,252992,499574
3067,Kyrgyzstan,KGZ,1997,252426,257769,510195
3068,Kyrgyzstan,KGZ,1998,258423,262539,520962
3069,Kyrgyzstan,KGZ,1999,263963,267039,531002
3070,Kyrgyzstan,KGZ,2000,268583,271075,539658
3071,Kyrgyzstan,KGZ,2001,272292,274680,546972
3072,Kyrgyzstan,KGZ,2002,275848,277896,553744
3073,Kyrgyzstan,KGZ,2003,279184,281469,560653
3074,Kyrgyzstan,KGZ,2004,282287,285074,567361
3075,Kyrgyzstan,KGZ,2005,285366,288637,574003
3076,Kyrgyzstan,KGZ,2006,287977,291914,579891
3077,Kyrgyzstan,KGZ,2007,289703,294889,584592
3078,Kyrgyzstan,KGZ,2008,291459,297536,588995
3079,Kyrgyzstan,KGZ,2009,293392,300536,593928
3080,Kyrgyzstan,KGZ,2010,295665,303842,599507
3081,Kyrgyzstan,KGZ,2011,298498,307643,606141
3082,Kyrgyzstan,KGZ,2012,301509,311468,612977
3083,Kyrgyzstan,KGZ,2013,304717,315602,620319
3084,Kyrgyzstan,KGZ,2014,308259,319805,628064
3085,Kyrgyzstan,KGZ,2015,312106,324244,636350
3086,Kyrgyzstan,KGZ,2016,316250,328531,644781
3087,Kyrgyzstan,KGZ,2017,320762,332983,653745
3088,Kyrgyzstan,KGZ,2018,325707,338061,663768
3089,Kyrgyzstan,KGZ,2019,330975,343530,674505
3090,Laos,LAO,1990,225204,251584,476788
3091,Laos,LAO,1991,232187,258218,490405
3092,Laos,LAO,1992,239380,264835,504215
3093,Laos,LAO,1993,246134,271177,517311
3094,Laos,LAO,1994,252489,277254,529743
3095,Laos,LAO,1995,259147,283410,542557
3096,Laos,LAO,1996,265716,289276,554992
3097,Laos,LAO,1997,271994,294599,566593
3098,Laos,LAO,1998,278000,299544,577544
3099,Laos,LAO,1999,284100,304607,588707
3100,Laos,LAO,2000,290352,310246,600598
3101,Laos,LAO,2001,296788,316504,613292
3102,Laos,LAO,2002,303326,323112,626438
3103,Laos,LAO,2003,309473,329605,639078
3104,Laos,LAO,2004,315376,335819,651195
3105,Laos,LAO,2005,321490,342004,663494
3106,Laos,LAO,2006,327793,347649,675442
3107,Laos,LAO,2007,333813,352783,686596
3108,Laos,LAO,2008,339507,357546,697053
3109,Laos,LAO,2009,344911,362048,706959
3110,Laos,LAO,2010,350067,366873,716940
3111,Laos,LAO,2011,354933,372159,727092
3112,Laos,LAO,2012,359468,377856,737324
3113,Laos,LAO,2013,364309,383833,748142
3114,Laos,LAO,2014,368879,389630,758509
3115,Laos,LAO,2015,373378,395486,768864
3116,Laos,LAO,2016,377589,401088,778677
3117,Laos,LAO,2017,381955,406787,788742
3118,Laos,LAO,2018,387284,412359,799643
3119,Laos,LAO,2019,393716,417988,811704
3120,Latin America & Caribbean (WB),,1990,25833716,29788977,55622693
3121,Latin America & Caribbean (WB),,1991,26327711,30464787,56792498
3122,Latin America & Caribbean (WB),,1992,26840419,31167582,58008001
3123,Latin America & Caribbean (WB),,1993,27366724,31885021,59251745
3124,Latin America & Caribbean (WB),,1994,27900778,32607511,60508289
3125,Latin America & Caribbean (WB),,1995,28437064,33327711,61764775
3126,Latin America & Caribbean (WB),,1996,29054746,34208012,63262758
3127,Latin America & Caribbean (WB),,1997,29792125,35344671,65136796
3128,Latin America & Caribbean (WB),,1998,30583054,36622544,67205598
3129,Latin America & Caribbean (WB),,1999,31360476,37916354,69276830
3130,Latin America & Caribbean (WB),,2000,32043686,39101952,71145638
3131,Latin America & Caribbean (WB),,2001,32667841,40241040,72908881
3132,Latin America & Caribbean (WB),,2002,33307584,41436596,74744180
3133,Latin America & Caribbean (WB),,2003,33939456,42620949,76560405
3134,Latin America & Caribbean (WB),,2004,34547282,43706662,78253944
3135,Latin America & Caribbean (WB),,2005,35108989,44609799,79718788
3136,Latin America & Caribbean (WB),,2006,35568575,45274966,80843541
3137,Latin America & Caribbean (WB),,2007,35914572,45764304,81678876
3138,Latin America & Caribbean (WB),,2008,36210794,46173625,82384419
3139,Latin America & Caribbean (WB),,2009,36517091,46602041,83119132
3140,Latin America & Caribbean (WB),,2010,36892137,47153695,84045832
3141,Latin America & Caribbean (WB),,2011,37313726,47632976,84946702
3142,Latin America & Caribbean (WB),,2012,37723015,47864955,85587970
3143,Latin America & Caribbean (WB),,2013,38132377,48002409,86134786
3144,Latin America & Caribbean (WB),,2014,38548379,48200480,86748859
3145,Latin America & Caribbean (WB),,2015,38980184,48633539,87613723
3146,Latin America & Caribbean (WB),,2016,39468993,49334577,88803570
3147,Latin America & Caribbean (WB),,2017,39930910,50027561,89958471
3148,Latin America & Caribbean (WB),,2018,40344413,50633840,90978253
3149,Latin America & Caribbean (WB),,2019,40766401,51237443,92003844
3150,Latvia,LVA,1990,148848,200813,349661
3151,Latvia,LVA,1991,148867,200416,349283
3152,Latvia,LVA,1992,148577,199717,348294
3153,Latvia,LVA,1993,147822,198635,346457
3154,Latvia,LVA,1994,146452,197124,343576
3155,Latvia,LVA,1995,144968,195401,340369
3156,Latvia,LVA,1996,143602,193567,337169
3157,Latvia,LVA,1997,142428,191690,334118
3158,Latvia,LVA,1998,141173,189732,330905
3159,Latvia,LVA,1999,139893,187637,327530
3160,Latvia,LVA,2000,138634,185868,324502
3161,Latvia,LVA,2001,137094,184016,321110
3162,Latvia,LVA,2002,135121,181836,316957
3163,Latvia,LVA,2003,132964,179470,312434
3164,Latvia,LVA,2004,130784,177032,307816
3165,Latvia,LVA,2005,128718,174685,303403
3166,Latvia,LVA,2006,126556,172260,298816
3167,Latvia,LVA,2007,124120,169499,293619
3168,Latvia,LVA,2008,121724,166662,288386
3169,Latvia,LVA,2009,119398,163897,283295
3170,Latvia,LVA,2010,117262,161252,278514
3171,Latvia,LVA,2011,115280,158795,274075
3172,Latvia,LVA,2012,113436,156506,269942
3173,Latvia,LVA,2013,111880,154376,266256
3174,Latvia,LVA,2014,110439,152369,262808
3175,Latvia,LVA,2015,109135,150509,259644
3176,Latvia,LVA,2016,108062,148790,256852
3177,Latvia,LVA,2017,107102,147082,254184
3178,Latvia,LVA,2018,106234,145651,251885
3179,Latvia,LVA,2019,105371,144482,249853
3180,Lebanon,LBN,1990,225980,255854,481834
3181,Lebanon,LBN,1991,230439,261985,492424
3182,Lebanon,LBN,1992,234589,267890,502479
3183,Lebanon,LBN,1993,238712,273979,512691
3184,Lebanon,LBN,1994,242990,280293,523283
3185,Lebanon,LBN,1995,247282,286527,533809
3186,Lebanon,LBN,1996,250833,292638,543471
3187,Lebanon,LBN,1997,253325,298591,551916
3188,Lebanon,LBN,1998,255231,304568,559799
3189,Lebanon,LBN,1999,257195,310437,567632
3190,Lebanon,LBN,2000,259387,316131,575518
3191,Lebanon,LBN,2001,261723,321567,583290
3192,Lebanon,LBN,2002,264379,327348,591727
3193,Lebanon,LBN,2003,267316,333495,600811
3194,Lebanon,LBN,2004,270185,339727,609912
3195,Lebanon,LBN,2005,273414,346282,619696
3196,Lebanon,LBN,2006,277948,353921,631869
3197,Lebanon,LBN,2007,283322,362298,645620
3198,Lebanon,LBN,2008,288378,370089,658467
3199,Lebanon,LBN,2009,292383,376749,669132
3200,Lebanon,LBN,2010,296755,383603,680358
3201,Lebanon,LBN,2011,310636,398975,709611
3202,Lebanon,LBN,2012,335807,424004,759811
3203,Lebanon,LBN,2013,354520,442818,797338
3204,Lebanon,LBN,2014,358533,448970,807503
3205,Lebanon,LBN,2015,358913,452037,810950
3206,Lebanon,LBN,2016,360074,455847,815921
3207,Lebanon,LBN,2017,361172,459357,820529
3208,Lebanon,LBN,2018,360081,458669,818750
3209,Lebanon,LBN,2019,355606,452365,807971
3210,Lesotho,LSO,1990,94895,113072,207967
3211,Lesotho,LSO,1991,96695,113666,210361
3212,Lesotho,LSO,1992,98452,114319,212771
3213,Lesotho,LSO,1993,100153,115102,215255
3214,Lesotho,LSO,1994,101638,116183,217821
3215,Lesotho,LSO,1995,102944,117624,220568
3216,Lesotho,LSO,1996,104155,119213,223368
3217,Lesotho,LSO,1997,105106,120727,225833
3218,Lesotho,LSO,1998,105779,122131,227910
3219,Lesotho,LSO,1999,106230,123202,229432
3220,Lesotho,LSO,2000,106437,123924,230361
3221,Lesotho,LSO,2001,106445,124374,230819
3222,Lesotho,LSO,2002,106298,124628,230926
3223,Lesotho,LSO,2003,106086,124742,230828
3224,Lesotho,LSO,2004,105858,124642,230500
3225,Lesotho,LSO,2005,105720,124448,230168
3226,Lesotho,LSO,2006,105806,124297,230103
3227,Lesotho,LSO,2007,106205,124332,230537
3228,Lesotho,LSO,2008,106935,124642,231577
3229,Lesotho,LSO,2009,107875,125276,233151
3230,Lesotho,LSO,2010,108866,126060,234926
3231,Lesotho,LSO,2011,109937,127102,237039
3232,Lesotho,LSO,2012,111110,128326,239436
3233,Lesotho,LSO,2013,112273,129551,241824
3234,Lesotho,LSO,2014,113397,130730,244127
3235,Lesotho,LSO,2015,114624,131941,246565
3236,Lesotho,LSO,2016,115783,133194,248977
3237,Lesotho,LSO,2017,116957,134681,251638
3238,Lesotho,LSO,2018,118265,136091,254356
3239,Lesotho,LSO,2019,119605,137516,257121
3240,Liberia,LBR,1990,93637,112349,205986
3241,Liberia,LBR,1991,100434,119014,219448
3242,Liberia,LBR,1992,103254,121888,225142
3243,Liberia,LBR,1993,103573,122441,226014
3244,Liberia,LBR,1994,106269,125436,231705
3245,Liberia,LBR,1995,113082,132357,245439
3246,Liberia,LBR,1996,123166,142428,265594
3247,Liberia,LBR,1997,131352,150682,282034
3248,Liberia,LBR,1998,139164,158516,297680
3249,Liberia,LBR,1999,147624,166854,314478
3250,Liberia,LBR,2000,153685,173256,326941
3251,Liberia,LBR,2001,155626,177210,332836
3252,Liberia,LBR,2002,153882,179447,333329
3253,Liberia,LBR,2003,153948,183739,337687
3254,Liberia,LBR,2004,158201,191497,349698
3255,Liberia,LBR,2005,165447,200744,366191
3256,Liberia,LBR,2006,174492,210676,385168
3257,Liberia,LBR,2007,182463,219488,401951
3258,Liberia,LBR,2008,188552,226373,414925
3259,Liberia,LBR,2009,197635,236180,433815
3260,Liberia,LBR,2010,208498,247769,456267
3261,Liberia,LBR,2011,213562,254262,467824
3262,Liberia,LBR,2012,215979,258253,474232
3263,Liberia,LBR,2013,220256,264029,484285
3264,Liberia,LBR,2014,225268,270589,495857
3265,Liberia,LBR,2015,230015,276884,506899
3266,Liberia,LBR,2016,234562,283439,518001
3267,Liberia,LBR,2017,239977,290660,530637
3268,Liberia,LBR,2018,246701,293072,539773
3269,Liberia,LBR,2019,254617,288942,543559
3270,Libya,LBY,1990,274514,267587,542101
3271,Libya,LBY,1991,277105,274948,552053
3272,Libya,LBY,1992,279723,282719,562442
3273,Libya,LBY,1993,282692,291102,573794
3274,Libya,LBY,1994,286637,300216,586853
3275,Libya,LBY,1995,291828,310034,601862
3276,Libya,LBY,1996,299716,320559,620275
3277,Libya,LBY,1997,309303,331223,640526
3278,Libya,LBY,1998,319817,342233,662050
3279,Libya,LBY,1999,330986,353192,684178
3280,Libya,LBY,2000,342140,364277,706417
3281,Libya,LBY,2001,353127,375405,728532
3282,Libya,LBY,2002,363902,386459,750361
3283,Libya,LBY,2003,374489,397439,771928
3284,Libya,LBY,2004,384868,408097,792965
3285,Libya,LBY,2005,394913,418280,813193
3286,Libya,LBY,2006,404732,428043,832775
3287,Libya,LBY,2007,413242,437428,850670
3288,Libya,LBY,2008,420756,446093,866849
3289,Libya,LBY,2009,425173,452578,877751
3290,Libya,LBY,2010,429656,459205,888861
3291,Libya,LBY,2011,440384,471116,911500
3292,Libya,LBY,2012,452392,484125,936517
3293,Libya,LBY,2013,462193,495285,957478
3294,Libya,LBY,2014,471091,505702,976793
3295,Libya,LBY,2015,479091,515616,994707
3296,Libya,LBY,2016,486923,524825,1011748
3297,Libya,LBY,2017,494385,533869,1028254
3298,Libya,LBY,2018,501274,543163,1044437
3299,Libya,LBY,2019,507462,553218,1060680
3300,Lithuania,LTU,1990,211976,278577,490553
3301,Lithuania,LTU,1991,213060,280387,493447
3302,Lithuania,LTU,1992,213896,282102,495998
3303,Lithuania,LTU,1993,214375,283259,497634
3304,Lithuania,LTU,1994,214381,283880,498261
3305,Lithuania,LTU,1995,214012,284153,498165
3306,Lithuania,LTU,1996,213840,284412,498252
3307,Lithuania,LTU,1997,214062,285053,499115
3308,Lithuania,LTU,1998,214089,285447,499536
3309,Lithuania,LTU,1999,213673,285254,498927
3310,Lithuania,LTU,2000,212666,284465,497131
3311,Lithuania,LTU,2001,210808,282699,493507
3312,Lithuania,LTU,2002,208218,280010,488228
3313,Lithuania,LTU,2003,205277,276725,482002
3314,Lithuania,LTU,2004,201985,273190,475175
3315,Lithuania,LTU,2005,198693,269739,468432
3316,Lithuania,LTU,2006,195209,266192,461401
3317,Lithuania,LTU,2007,191578,262533,454111
3318,Lithuania,LTU,2008,188046,258823,446869
3319,Lithuania,LTU,2009,184763,255415,440178
3320,Lithuania,LTU,2010,181794,252356,434150
3321,Lithuania,LTU,2011,178848,249200,428048
3322,Lithuania,LTU,2012,175952,245927,421879
3323,Lithuania,LTU,2013,173153,242647,415800
3324,Lithuania,LTU,2014,170613,239513,410126
3325,Lithuania,LTU,2015,168304,236607,404911
3326,Lithuania,LTU,2016,165895,233654,399549
3327,Lithuania,LTU,2017,163793,230753,394546
3328,Lithuania,LTU,2018,162116,227914,390030
3329,Lithuania,LTU,2019,160719,225019,385738
3330,Luxembourg,LUX,1990,25084,31804,56888
3331,Luxembourg,LUX,1991,25282,31959,57241
3332,Luxembourg,LUX,1992,25522,32169,57691
3333,Luxembourg,LUX,1993,25786,32448,58234
3334,Luxembourg,LUX,1994,26095,32747,58842
3335,Luxembourg,LUX,1995,26428,33086,59514
3336,Luxembourg,LUX,1996,26765,33460,60225
3337,Luxembourg,LUX,1997,27104,33858,60962
3338,Luxembourg,LUX,1998,27459,34279,61738
3339,Luxembourg,LUX,1999,27815,34700,62515
3340,Luxembourg,LUX,2000,28160,35094,63254
3341,Luxembourg,LUX,2001,28488,35441,63929
3342,Luxembourg,LUX,2002,28787,35738,64525
3343,Luxembourg,LUX,2003,29090,36034,65124
3344,Luxembourg,LUX,2004,29494,36410,65904
3345,Luxembourg,LUX,2005,29930,36839,66769
3346,Luxembourg,LUX,2006,30383,37343,67726
3347,Luxembourg,LUX,2007,30831,37775,68606
3348,Luxembourg,LUX,2008,31297,38242,69539
3349,Luxembourg,LUX,2009,31844,38771,70615
3350,Luxembourg,LUX,2010,32439,39402,71841
3351,Luxembourg,LUX,2011,33156,40163,73319
3352,Luxembourg,LUX,2012,34002,41085,75087
3353,Luxembourg,LUX,2013,34843,42025,76868
3354,Luxembourg,LUX,2014,35674,42980,78654
3355,Luxembourg,LUX,2015,36553,43988,80541
3356,Luxembourg,LUX,2016,37498,44936,82434
3357,Luxembourg,LUX,2017,38484,45960,84444
3358,Luxembourg,LUX,2018,39466,47041,86507
3359,Luxembourg,LUX,2019,40436,48139,88575
3360,Madagascar,MDG,1990,615528,648681,1264209
3361,Madagascar,MDG,1991,633209,666996,1300205
3362,Madagascar,MDG,1992,651282,685826,1337108
3363,Madagascar,MDG,1993,670356,705454,1375810
3364,Madagascar,MDG,1994,689720,725324,1415044
3365,Madagascar,MDG,1995,709747,746623,1456370
3366,Madagascar,MDG,1996,730288,768712,1499000
3367,Madagascar,MDG,1997,751806,791449,1543255
3368,Madagascar,MDG,1998,773763,815258,1589021
3369,Madagascar,MDG,1999,796855,839229,1636084
3370,Madagascar,MDG,2000,820950,864573,1685523
3371,Madagascar,MDG,2001,846439,890613,1737052
3372,Madagascar,MDG,2002,872524,916945,1789469
3373,Madagascar,MDG,2003,899763,944156,1843919
3374,Madagascar,MDG,2004,927640,972242,1899882
3375,Madagascar,MDG,2005,956941,1002057,1958998
3376,Madagascar,MDG,2006,986831,1033337,2020168
3377,Madagascar,MDG,2007,1017856,1066002,2083858
3378,Madagascar,MDG,2008,1049564,1100001,2149565
3379,Madagascar,MDG,2009,1082258,1134856,2217114
3380,Madagascar,MDG,2010,1116222,1170839,2287061
3381,Madagascar,MDG,2011,1150645,1207115,2357760
3382,Madagascar,MDG,2012,1186419,1244617,2431036
3383,Madagascar,MDG,2013,1223734,1282070,2505804
3384,Madagascar,MDG,2014,1261335,1321124,2582459
3385,Madagascar,MDG,2015,1299956,1361249,2661205
3386,Madagascar,MDG,2016,1338357,1403746,2742103
3387,Madagascar,MDG,2017,1377088,1447178,2824266
3388,Madagascar,MDG,2018,1417964,1489149,2907113
3389,Madagascar,MDG,2019,1460559,1530901,2991460
3390,Malawi,MWI,1990,477172,522596,999768
3391,Malawi,MWI,1991,496965,540635,1037600
3392,Malawi,MWI,1992,510195,552788,1062983
3393,Malawi,MWI,1993,505561,550300,1055861
3394,Malawi,MWI,1994,493836,541999,1035835
3395,Malawi,MWI,1995,497325,545858,1043183
3396,Malawi,MWI,1996,509948,557854,1067802
3397,Malawi,MWI,1997,522039,568929,1090968
3398,Malawi,MWI,1998,533660,579696,1113356
3399,Malawi,MWI,1999,544961,590464,1135425
3400,Malawi,MWI,2000,557343,602363,1159706
3401,Malawi,MWI,2001,570255,615937,1186192
3402,Malawi,MWI,2002,583904,629795,1213699
3403,Malawi,MWI,2003,597976,643844,1241820
3404,Malawi,MWI,2004,612445,658895,1271340
3405,Malawi,MWI,2005,627239,675057,1302296
3406,Malawi,MWI,2006,641666,691113,1332779
3407,Malawi,MWI,2007,655994,707891,1363885
3408,Malawi,MWI,2008,671896,726235,1398131
3409,Malawi,MWI,2009,688543,746316,1434859
3410,Malawi,MWI,2010,708052,768867,1476919
3411,Malawi,MWI,2011,729721,793496,1523217
3412,Malawi,MWI,2012,753053,820381,1573434
3413,Malawi,MWI,2013,778351,849002,1627353
3414,Malawi,MWI,2014,804871,879431,1684302
3415,Malawi,MWI,2015,832526,910727,1743253
3416,Malawi,MWI,2016,859859,943195,1803054
3417,Malawi,MWI,2017,887919,976190,1864109
3418,Malawi,MWI,2018,917437,1009251,1926688
3419,Malawi,MWI,2019,948455,1041833,1990288
3420,Malaysia,MYS,1990,852531,986831,1839362
3421,Malaysia,MYS,1991,879596,1017025,1896621
3422,Malaysia,MYS,1992,909761,1049262,1959023
3423,Malaysia,MYS,1993,941390,1083614,2025004
3424,Malaysia,MYS,1994,973942,1119080,2093022
3425,Malaysia,MYS,1995,1007677,1155648,2163325
3426,Malaysia,MYS,1996,1042514,1194199,2236713
3427,Malaysia,MYS,1997,1078590,1234921,2313511
3428,Malaysia,MYS,1998,1115285,1275932,2391217
3429,Malaysia,MYS,1999,1151044,1315641,2466685
3430,Malaysia,MYS,2000,1185526,1353350,2538876
3431,Malaysia,MYS,2001,1223241,1396151,2619392
3432,Malaysia,MYS,2002,1266932,1447709,2714641
3433,Malaysia,MYS,2003,1311757,1500964,2812721
3434,Malaysia,MYS,2004,1353181,1549393,2902574
3435,Malaysia,MYS,2005,1387045,1586899,2973944
3436,Malaysia,MYS,2006,1416237,1614665,3030902
3437,Malaysia,MYS,2007,1443425,1640987,3084412
3438,Malaysia,MYS,2008,1469356,1665275,3134631
3439,Malaysia,MYS,2009,1494680,1689354,3184034
3440,Malaysia,MYS,2010,1520018,1714305,3234323
3441,Malaysia,MYS,2011,1547814,1741117,3288931
3442,Malaysia,MYS,2012,1577635,1769619,3347254
3443,Malaysia,MYS,2013,1607907,1798764,3406671
3444,Malaysia,MYS,2014,1637468,1828330,3465798
3445,Malaysia,MYS,2015,1664190,1856071,3520261
3446,Malaysia,MYS,2016,1685121,1883480,3568601
3447,Malaysia,MYS,2017,1706632,1909369,3616001
3448,Malaysia,MYS,2018,1732306,1932785,3665091
3449,Malaysia,MYS,2019,1760707,1954664,3715371
3450,Maldives,MDV,1990,10860,11589,22449
3451,Maldives,MDV,1991,11167,11984,23151
3452,Maldives,MDV,1992,11493,12384,23877
3453,Maldives,MDV,1993,11835,12799,24634
3454,Maldives,MDV,1994,12179,13215,25394
3455,Maldives,MDV,1995,12536,13630,26166
3456,Maldives,MDV,1996,12886,14022,26908
3457,Maldives,MDV,1997,13217,14386,27603
3458,Maldives,MDV,1998,13551,14734,28285
3459,Maldives,MDV,1999,13861,15084,28945
3460,Maldives,MDV,2000,14142,15440,29582
3461,Maldives,MDV,2001,14405,15820,30225
3462,Maldives,MDV,2002,14652,16205,30857
3463,Maldives,MDV,2003,14909,16600,31509
3464,Maldives,MDV,2004,15204,16988,32192
3465,Maldives,MDV,2005,15561,17375,32936
3466,Maldives,MDV,2006,16012,17744,33756
3467,Maldives,MDV,2007,16598,18086,34684
3468,Maldives,MDV,2008,17300,18431,35731
3469,Maldives,MDV,2009,18129,18771,36900
3470,Maldives,MDV,2010,19088,19136,38224
3471,Maldives,MDV,2011,20186,19520,39706
3472,Maldives,MDV,2012,21387,19916,41303
3473,Maldives,MDV,2013,22702,20331,43033
3474,Maldives,MDV,2014,24091,20759,44850
3475,Maldives,MDV,2015,25534,21192,46726
3476,Maldives,MDV,2016,26967,21660,48627
3477,Maldives,MDV,2017,28439,22127,50566
3478,Maldives,MDV,2018,29968,22577,52545
3479,Maldives,MDV,2019,31541,23013,54554
3480,Mali,MLI,1990,380175,401687,781862
3481,Mali,MLI,1991,386337,407217,793554
3482,Mali,MLI,1992,392530,412883,805413
3483,Mali,MLI,1993,399780,419761,819541
3484,Mali,MLI,1994,410090,428996,839086
3485,Mali,MLI,1995,421761,439608,861369
3486,Mali,MLI,1996,433467,450157,883624
3487,Mali,MLI,1997,444895,460751,905646
3488,Mali,MLI,1998,456585,471653,928238
3489,Mali,MLI,1999,469391,483394,952785
3490,Mali,MLI,2000,483247,496535,979782
3491,Mali,MLI,2001,497839,510530,1008369
3492,Mali,MLI,2002,513482,525486,1038968
3493,Mali,MLI,2003,530290,541732,1072022
3494,Mali,MLI,2004,548630,559681,1108311
3495,Mali,MLI,2005,568380,579007,1147387
3496,Mali,MLI,2006,589516,599654,1189170
3497,Mali,MLI,2007,612219,621847,1234066
3498,Mali,MLI,2008,636046,645501,1281547
3499,Mali,MLI,2009,661105,670283,1331388
3500,Mali,MLI,2010,685470,694810,1380280
3501,Mali,MLI,2011,708970,719234,1428204
3502,Mali,MLI,2012,735193,746480,1481673
3503,Mali,MLI,2013,764781,776819,1541600
3504,Mali,MLI,2014,795243,808278,1603521
3505,Mali,MLI,2015,825623,840604,1666227
3506,Mali,MLI,2016,856048,873605,1729653
3507,Mali,MLI,2017,888378,908094,1796472
3508,Mali,MLI,2018,922870,943148,1866018
3509,Mali,MLI,2019,960586,979927,1940513
3510,Malta,MLT,1990,24595,30579,55174
3511,Malta,MLT,1991,24817,30841,55658
3512,Malta,MLT,1992,25058,31107,56165
3513,Malta,MLT,1993,25299,31380,56679
3514,Malta,MLT,1994,25545,31667,57212
3515,Malta,MLT,1995,25781,31945,57726
3516,Malta,MLT,1996,26022,32223,58245
3517,Malta,MLT,1997,26273,32500,58773
3518,Malta,MLT,1998,26523,32794,59317
3519,Malta,MLT,1999,26775,33091,59866
3520,Malta,MLT,2000,27016,33371,60387
3521,Malta,MLT,2001,27260,33667,60927
3522,Malta,MLT,2002,27493,33966,61459
3523,Malta,MLT,2003,27715,34260,61975
3524,Malta,MLT,2004,27908,34526,62434
3525,Malta,MLT,2005,28086,34774,62860
3526,Malta,MLT,2006,28253,34960,63213
3527,Malta,MLT,2007,28400,35092,63492
3528,Malta,MLT,2008,28528,35199,63727
3529,Malta,MLT,2009,28640,35287,63927
3530,Malta,MLT,2010,28742,35424,64166
3531,Malta,MLT,2011,28849,35581,64430
3532,Malta,MLT,2012,28941,35765,64706
3533,Malta,MLT,2013,29045,35956,65001
3534,Malta,MLT,2014,29128,36128,65256
3535,Malta,MLT,2015,29206,36241,65447
3536,Malta,MLT,2016,29242,36230,65472
3537,Malta,MLT,2017,29277,36199,65476
3538,Malta,MLT,2018,29377,36352,65729
3539,Malta,MLT,2019,29504,36667,66171
3540,Marshall Islands,MHL,1990,2421,2261,4682
3541,Marshall Islands,MHL,1991,2482,2321,4803
3542,Marshall Islands,MHL,1992,2539,2380,4919
3543,Marshall Islands,MHL,1993,2594,2438,5032
3544,Marshall Islands,MHL,1994,2647,2493,5140
3545,Marshall Islands,MHL,1995,2696,2545,5241
3546,Marshall Islands,MHL,1996,2743,2597,5340
3547,Marshall Islands,MHL,1997,2787,2646,5433
3548,Marshall Islands,MHL,1998,2825,2691,5516
3549,Marshall Islands,MHL,1999,2860,2731,5591
3550,Marshall Islands,MHL,2000,2891,2765,5656
3551,Marshall Islands,MHL,2001,2913,2792,5705
3552,Marshall Islands,MHL,2002,2933,2815,5748
3553,Marshall Islands,MHL,2003,2949,2833,5782
3554,Marshall Islands,MHL,2004,2963,2849,5812
3555,Marshall Islands,MHL,2005,2976,2866,5842
3556,Marshall Islands,MHL,2006,2990,2883,5873
3557,Marshall Islands,MHL,2007,3004,2900,5904
3558,Marshall Islands,MHL,2008,3018,2919,5937
3559,Marshall Islands,MHL,2009,3033,2939,5972
3560,Marshall Islands,MHL,2010,3047,2959,6006
3561,Marshall Islands,MHL,2011,3065,2980,6045
3562,Marshall Islands,MHL,2012,3086,3002,6088
3563,Marshall Islands,MHL,2013,3106,3026,6132
3564,Marshall Islands,MHL,2014,3127,3050,6177
3565,Marshall Islands,MHL,2015,3147,3074,6221
3566,Marshall Islands,MHL,2016,3161,3101,6262
3567,Marshall Islands,MHL,2017,3175,3127,6302
3568,Marshall Islands,MHL,2018,3197,3158,6355
3569,Marshall Islands,MHL,2019,3222,3192,6414
3570,Mauritania,MRT,1990,92890,92674,185564
3571,Mauritania,MRT,1991,95349,94990,190339
3572,Mauritania,MRT,1992,97836,97309,195145
3573,Mauritania,MRT,1993,100346,99674,200020
3574,Mauritania,MRT,1994,102829,102085,204914
3575,Mauritania,MRT,1995,105283,104576,209859
3576,Mauritania,MRT,1996,107737,107090,214827
3577,Mauritania,MRT,1997,110162,109564,219726
3578,Mauritania,MRT,1998,112621,112095,224716
3579,Mauritania,MRT,1999,115093,114726,229819
3580,Mauritania,MRT,2000,117678,117457,235135
3581,Mauritania,MRT,2001,120444,120265,240709
3582,Mauritania,MRT,2002,123253,123199,246452
3583,Mauritania,MRT,2003,126173,126139,252312
3584,Mauritania,MRT,2004,129153,129207,258360
3585,Mauritania,MRT,2005,132159,132342,264501
3586,Mauritania,MRT,2006,135187,135477,270664
3587,Mauritania,MRT,2007,138214,138580,276794
3588,Mauritania,MRT,2008,141333,141740,283073
3589,Mauritania,MRT,2009,144495,145079,289574
3590,Mauritania,MRT,2010,147929,148575,296504
3591,Mauritania,MRT,2011,151663,152456,304119
3592,Mauritania,MRT,2012,155700,156834,312534
3593,Mauritania,MRT,2013,159922,161432,321354
3594,Mauritania,MRT,2014,164300,166100,330400
3595,Mauritania,MRT,2015,168710,170730,339440
3596,Mauritania,MRT,2016,173197,175169,348366
3597,Mauritania,MRT,2017,177636,179714,357350
3598,Mauritania,MRT,2018,182163,184570,366733
3599,Mauritania,MRT,2019,186748,189547,376295
3600,Mauritius,MUS,1990,59911,73545,133456
3601,Mauritius,MUS,1991,60470,74449,134919
3602,Mauritius,MUS,1992,61088,75394,136482
3603,Mauritius,MUS,1993,61710,76378,138088
3604,Mauritius,MUS,1994,62306,77413,139719
3605,Mauritius,MUS,1995,62897,78448,141345
3606,Mauritius,MUS,1996,63509,79620,143129
3607,Mauritius,MUS,1997,64176,81039,145215
3608,Mauritius,MUS,1998,64885,82515,147400
3609,Mauritius,MUS,1999,65587,83917,149504
3610,Mauritius,MUS,2000,66197,84999,151196
3611,Mauritius,MUS,2001,66714,85840,152554
3612,Mauritius,MUS,2002,67179,86597,153776
3613,Mauritius,MUS,2003,67626,87275,154901
3614,Mauritius,MUS,2004,68064,87881,155945
3615,Mauritius,MUS,2005,68436,88345,156781
3616,Mauritius,MUS,2006,68863,88779,157642
3617,Mauritius,MUS,2007,69295,89121,158416
3618,Mauritius,MUS,2008,69717,89451,159168
3619,Mauritius,MUS,2009,70030,89723,159753
3620,Mauritius,MUS,2010,70290,89987,160277
3621,Mauritius,MUS,2011,70468,90015,160483
3622,Mauritius,MUS,2012,70494,89747,160241
3623,Mauritius,MUS,2013,70506,89373,159879
3624,Mauritius,MUS,2014,70526,89049,159575
3625,Mauritius,MUS,2015,70601,89065,159666
3626,Mauritius,MUS,2016,70587,89192,159779
3627,Mauritius,MUS,2017,70569,89317,159886
3628,Mauritius,MUS,2018,70671,89569,160240
3629,Mauritius,MUS,2019,70852,89804,160656
3630,Mexico,MEX,1990,3974950,4330309,8305259
3631,Mexico,MEX,1991,4057242,4438359,8495601
3632,Mexico,MEX,1992,4144078,4551544,8695622
3633,Mexico,MEX,1993,4232312,4667485,8899797
3634,Mexico,MEX,1994,4320813,4784889,9105702
3635,Mexico,MEX,1995,4406793,4900381,9307174
3636,Mexico,MEX,1996,4494576,5041199,9535775
3637,Mexico,MEX,1997,4588203,5221099,9809302
3638,Mexico,MEX,1998,4684003,5422050,10106053
3639,Mexico,MEX,1999,4779098,5624684,10403782
3640,Mexico,MEX,2000,4868034,5808211,10676245
3641,Mexico,MEX,2001,4956667,5978829,10935496
3642,Mexico,MEX,2002,5051607,6153593,11205200
3643,Mexico,MEX,2003,5150093,6326361,11476454
3644,Mexico,MEX,2004,5250048,6487225,11737273
3645,Mexico,MEX,2005,5348525,6626072,11974597
3646,Mexico,MEX,2006,5447357,6767156,12214513
3647,Mexico,MEX,2007,5549043,6931184,12480227
3648,Mexico,MEX,2008,5649706,7103376,12753082
3649,Mexico,MEX,2009,5744902,7267125,13012027
3650,Mexico,MEX,2010,5831580,7406852,13238432
3651,Mexico,MEX,2011,5910057,7516599,13426656
3652,Mexico,MEX,2012,5984512,7606092,13590604
3653,Mexico,MEX,2013,6056383,7683603,13739986
3654,Mexico,MEX,2014,6128465,7762617,13891082
3655,Mexico,MEX,2015,6201872,7852515,14054387
3656,Mexico,MEX,2016,6282715,7959448,14242163
3657,Mexico,MEX,2017,6360929,8066175,14427104
3658,Mexico,MEX,2018,6434642,8165366,14600008
3659,Mexico,MEX,2019,6509866,8264371,14774237
3660,Micronesia (country),FSM,1990,5639,5324,10963
3661,Micronesia (country),FSM,1991,5714,5417,11131
3662,Micronesia (country),FSM,1992,5781,5503,11284
3663,Micronesia (country),FSM,1993,5841,5583,11424
3664,Micronesia (country),FSM,1994,5892,5655,11547
3665,Micronesia (country),FSM,1995,5933,5718,11651
3666,Micronesia (country),FSM,1996,5967,5777,11744
3667,Micronesia (country),FSM,1997,5991,5826,11817
3668,Micronesia (country),FSM,1998,6004,5868,11872
3669,Micronesia (country),FSM,1999,6012,5899,11911
3670,Micronesia (country),FSM,2000,6017,5921,11938
3671,Micronesia (country),FSM,2001,6012,5928,11940
3672,Micronesia (country),FSM,2002,5997,5921,11918
3673,Micronesia (country),FSM,2003,5976,5906,11882
3674,Micronesia (country),FSM,2004,5959,5890,11849
3675,Micronesia (country),FSM,2005,5942,5875,11817
3676,Micronesia (country),FSM,2006,5930,5866,11796
3677,Micronesia (country),FSM,2007,5921,5862,11783
3678,Micronesia (country),FSM,2008,5915,5858,11773
3679,Micronesia (country),FSM,2009,5908,5855,11763
3680,Micronesia (country),FSM,2010,5904,5853,11757
3681,Micronesia (country),FSM,2011,5902,5852,11754
3682,Micronesia (country),FSM,2012,5906,5855,11761
3683,Micronesia (country),FSM,2013,5909,5860,11769
3684,Micronesia (country),FSM,2014,5910,5865,11775
3685,Micronesia (country),FSM,2015,5906,5870,11776
3686,Micronesia (country),FSM,2016,5889,5866,11755
3687,Micronesia (country),FSM,2017,5868,5867,11735
3688,Micronesia (country),FSM,2018,5861,5872,11733
3689,Micronesia (country),FSM,2019,5859,5890,11749
3690,Middle East & North Africa (WB),,1990,18562523,18750284,37312807
3691,Middle East & North Africa (WB),,1991,19038133,19299628,38337761
3692,Middle East & North Africa (WB),,1992,19479499,19822599,39302098
3693,Middle East & North Africa (WB),,1993,19963758,20372333,40336091
3694,Middle East & North Africa (WB),,1994,20467662,20941936,41409598
3695,Middle East & North Africa (WB),,1995,20965340,21505112,42470452
3696,Middle East & North Africa (WB),,1996,21475300,22048841,43524141
3697,Middle East & North Africa (WB),,1997,22003750,22561598,44565348
3698,Middle East & North Africa (WB),,1998,22537721,23070176,45607897
3699,Middle East & North Africa (WB),,1999,23064163,23590442,46654605
3700,Middle East & North Africa (WB),,2000,23565356,24140855,47706211
3701,Middle East & North Africa (WB),,2001,24039797,24720214,48760011
3702,Middle East & North Africa (WB),,2002,24510393,25316771,49827164
3703,Middle East & North Africa (WB),,2003,24998481,25941221,50939702
3704,Middle East & North Africa (WB),,2004,25474289,26559982,52034271
3705,Middle East & North Africa (WB),,2005,25956683,27164237,53120920
3706,Middle East & North Africa (WB),,2006,26529291,27797234,54326525
3707,Middle East & North Africa (WB),,2007,27206170,28489324,55695494
3708,Middle East & North Africa (WB),,2008,27953672,29209044,57162716
3709,Middle East & North Africa (WB),,2009,28660028,29900087,58560115
3710,Middle East & North Africa (WB),,2010,29236847,30525620,59762467
3711,Middle East & North Africa (WB),,2011,29806618,31123358,60929976
3712,Middle East & North Africa (WB),,2012,30388162,31734812,62122974
3713,Middle East & North Africa (WB),,2013,30940839,32334415,63275254
3714,Middle East & North Africa (WB),,2014,31468440,32909342,64377782
3715,Middle East & North Africa (WB),,2015,31995397,33452869,65448266
3716,Middle East & North Africa (WB),,2016,32473534,33906956,66380490
3717,Middle East & North Africa (WB),,2017,32964335,34386382,67350717
3718,Middle East & North Africa (WB),,2018,33503936,34998740,68502676
3719,Middle East & North Africa (WB),,2019,34044202,35680131,69724333
3720,Moldova,MDA,1990,244123,308540,552663
3721,Moldova,MDA,1991,245644,309298,554942
3722,Moldova,MDA,1992,247085,309653,556738
3723,Moldova,MDA,1993,248324,310043,558367
3724,Moldova,MDA,1994,249233,310007,559240
3725,Moldova,MDA,1995,249764,309864,559628
3726,Moldova,MDA,1996,250594,309744,560338
3727,Moldova,MDA,1997,251821,310020,561841
3728,Moldova,MDA,1998,252943,310320,563263
3729,Moldova,MDA,1999,253379,310012,563391
3730,Moldova,MDA,2000,252630,308843,561473
3731,Moldova,MDA,2001,251035,306751,557786
3732,Moldova,MDA,2002,249225,304250,553475
3733,Moldova,MDA,2003,247017,301519,548536
3734,Moldova,MDA,2004,244821,298789,543610
3735,Moldova,MDA,2005,242428,296360,538788
3736,Moldova,MDA,2006,239851,293776,533627
3737,Moldova,MDA,2007,237209,291088,528297
3738,Moldova,MDA,2008,234448,288415,522863
3739,Moldova,MDA,2009,231775,285807,517582
3740,Moldova,MDA,2010,229291,283701,512992
3741,Moldova,MDA,2011,227236,281996,509232
3742,Moldova,MDA,2012,225271,280613,505884
3743,Moldova,MDA,2013,223550,279234,502784
3744,Moldova,MDA,2014,221828,277926,499754
3745,Moldova,MDA,2015,220107,276549,496656
3746,Moldova,MDA,2016,218525,275029,493554
3747,Moldova,MDA,2017,217184,273682,490866
3748,Moldova,MDA,2018,215957,272264,488221
3749,Moldova,MDA,2019,214808,270683,485491
3750,Monaco,MCO,1990,1986,2741,4727
3751,Monaco,MCO,1991,2011,2756,4767
3752,Monaco,MCO,1992,2035,2770,4805
3753,Monaco,MCO,1993,2056,2783,4839
3754,Monaco,MCO,1994,2078,2795,4873
3755,Monaco,MCO,1995,2098,2807,4905
3756,Monaco,MCO,1996,2118,2819,4937
3757,Monaco,MCO,1997,2137,2832,4969
3758,Monaco,MCO,1998,2155,2845,5000
3759,Monaco,MCO,1999,2174,2859,5033
3760,Monaco,MCO,2000,2194,2875,5069
3761,Monaco,MCO,2001,2214,2893,5107
3762,Monaco,MCO,2002,2234,2913,5147
3763,Monaco,MCO,2003,2252,2935,5187
3764,Monaco,MCO,2004,2271,2957,5228
3765,Monaco,MCO,2005,2291,2981,5272
3766,Monaco,MCO,2006,2310,3005,5315
3767,Monaco,MCO,2007,2330,3030,5360
3768,Monaco,MCO,2008,2350,3057,5407
3769,Monaco,MCO,2009,2369,3082,5451
3770,Monaco,MCO,2010,2386,3109,5495
3771,Monaco,MCO,2011,2402,3135,5537
3772,Monaco,MCO,2012,2417,3160,5577
3773,Monaco,MCO,2013,2432,3185,5617
3774,Monaco,MCO,2014,2445,3206,5651
3775,Monaco,MCO,2015,2458,3225,5683
3776,Monaco,MCO,2016,2472,3241,5713
3777,Monaco,MCO,2017,2478,3250,5728
3778,Monaco,MCO,2018,2485,3265,5750
3779,Monaco,MCO,2019,2496,3283,5779
3780,Mongolia,MNG,1990,108072,106539,214611
3781,Mongolia,MNG,1991,110653,109407,220060
3782,Mongolia,MNG,1992,113165,112135,225300
3783,Mongolia,MNG,1993,115600,114751,230351
3784,Mongolia,MNG,1994,117990,117346,235336
3785,Mongolia,MNG,1995,120380,119821,240201
3786,Mongolia,MNG,1996,122683,122279,244962
3787,Mongolia,MNG,1997,125044,124682,249726
3788,Mongolia,MNG,1998,127430,127001,254431
3789,Mongolia,MNG,1999,129751,129385,259136
3790,Mongolia,MNG,2000,132132,131930,264062
3791,Mongolia,MNG,2001,134118,134135,268253
3792,Mongolia,MNG,2002,135620,135952,271572
3793,Mongolia,MNG,2003,136920,137588,274508
3794,Mongolia,MNG,2004,138222,139231,277453
3795,Mongolia,MNG,2005,139710,141505,281215
3796,Mongolia,MNG,2006,141420,143894,285314
3797,Mongolia,MNG,2007,143067,146265,289332
3798,Mongolia,MNG,2008,144708,148486,293194
3799,Mongolia,MNG,2009,146377,150780,297157
3800,Mongolia,MNG,2010,148038,153397,301435
3801,Mongolia,MNG,2011,149658,156070,305728
3802,Mongolia,MNG,2012,151390,158795,310185
3803,Mongolia,MNG,2013,153164,161554,314718
3804,Mongolia,MNG,2014,155007,164353,319360
3805,Mongolia,MNG,2015,157234,167460,324694
3806,Mongolia,MNG,2016,161178,172668,333846
3807,Mongolia,MNG,2017,165235,177993,343228
3808,Mongolia,MNG,2018,167661,181047,348708
3809,Mongolia,MNG,2019,169755,183516,353271
3810,Montenegro,MNE,1990,31588,37986,69574
3811,Montenegro,MNE,1991,31846,38364,70210
3812,Montenegro,MNE,1992,32085,38741,70826
3813,Montenegro,MNE,1993,32297,39091,71388
3814,Montenegro,MNE,1994,32475,39406,71881
3815,Montenegro,MNE,1995,32621,39690,72311
3816,Montenegro,MNE,1996,32741,39957,72698
3817,Montenegro,MNE,1997,32854,40212,73066
3818,Montenegro,MNE,1998,32943,40458,73401
3819,Montenegro,MNE,1999,32985,40672,73657
3820,Montenegro,MNE,2000,33024,40851,73875
3821,Montenegro,MNE,2001,33034,41008,74042
3822,Montenegro,MNE,2002,33031,41135,74166
3823,Montenegro,MNE,2003,32997,41228,74225
3824,Montenegro,MNE,2004,32956,41299,74255
3825,Montenegro,MNE,2005,32901,41356,74257
3826,Montenegro,MNE,2006,32839,41383,74222
3827,Montenegro,MNE,2007,32755,41382,74137
3828,Montenegro,MNE,2008,32692,41364,74056
3829,Montenegro,MNE,2009,32629,41315,73944
3830,Montenegro,MNE,2010,32569,41290,73859
3831,Montenegro,MNE,2011,32522,41254,73776
3832,Montenegro,MNE,2012,32468,41196,73664
3833,Montenegro,MNE,2013,32413,41125,73538
3834,Montenegro,MNE,2014,32362,41066,73428
3835,Montenegro,MNE,2015,32297,41022,73319
3836,Montenegro,MNE,2016,32233,41006,73239
3837,Montenegro,MNE,2017,32177,40997,73174
3838,Montenegro,MNE,2018,32112,41009,73121
3839,Montenegro,MNE,2019,32028,41038,73066
3840,Morocco,MAR,1990,1781663,1972752,3754415
3841,Morocco,MAR,1991,1814122,2020022,3834144
3842,Morocco,MAR,1992,1846445,2066230,3912675
3843,Morocco,MAR,1993,1876580,2110885,3987465
3844,Morocco,MAR,1994,1907320,2155211,4062531
3845,Morocco,MAR,1995,1938267,2197122,4135389
3846,Morocco,MAR,1996,1969562,2239251,4208813
3847,Morocco,MAR,1997,2000628,2278544,4279172
3848,Morocco,MAR,1998,2031475,2317350,4348825
3849,Morocco,MAR,1999,2062050,2355765,4417815
3850,Morocco,MAR,2000,2091957,2394900,4486857
3851,Morocco,MAR,2001,2120967,2434440,4555407
3852,Morocco,MAR,2002,2149717,2472621,4622338
3853,Morocco,MAR,2003,2177817,2510420,4688237
3854,Morocco,MAR,2004,2205381,2546074,4751455
3855,Morocco,MAR,2005,2232657,2579893,4812550
3856,Morocco,MAR,2006,2259649,2610379,4870028
3857,Morocco,MAR,2007,2285645,2640545,4926190
3858,Morocco,MAR,2008,2311111,2668898,4980009
3859,Morocco,MAR,2009,2336677,2696521,5033198
3860,Morocco,MAR,2010,2362264,2723426,5085690
3861,Morocco,MAR,2011,2388839,2749335,5138174
3862,Morocco,MAR,2012,2416746,2775441,5192187
3863,Morocco,MAR,2013,2443358,2800934,5244292
3864,Morocco,MAR,2014,2470753,2825661,5296414
3865,Morocco,MAR,2015,2496775,2850606,5347381
3866,Morocco,MAR,2016,2520879,2874061,5394940
3867,Morocco,MAR,2017,2544188,2897548,5441736
3868,Morocco,MAR,2018,2566890,2926496,5493386
3869,Morocco,MAR,2019,2589483,2962678,5552161
3870,Mozambique,MOZ,1990,713715,818410,1532125
3871,Mozambique,MOZ,1991,712599,820627,1533226
3872,Mozambique,MOZ,1992,725770,836082,1561852
3873,Mozambique,MOZ,1993,768591,878358,1646949
3874,Mozambique,MOZ,1994,820419,928543,1748962
3875,Mozambique,MOZ,1995,854909,964426,1819335
3876,Mozambique,MOZ,1996,874489,986668,1861157
3877,Mozambique,MOZ,1997,890264,1005496,1895760
3878,Mozambique,MOZ,1998,905940,1024736,1930676
3879,Mozambique,MOZ,1999,922369,1043957,1966326
3880,Mozambique,MOZ,2000,940148,1064147,2004295
3881,Mozambique,MOZ,2001,960018,1085578,2045596
3882,Mozambique,MOZ,2002,981338,1107198,2088536
3883,Mozambique,MOZ,2003,1004035,1129875,2133910
3884,Mozambique,MOZ,2004,1027935,1154037,2181972
3885,Mozambique,MOZ,2005,1052296,1179183,2231479
3886,Mozambique,MOZ,2006,1077724,1205412,2283136
3887,Mozambique,MOZ,2007,1103016,1233027,2336043
3888,Mozambique,MOZ,2008,1130281,1263258,2393539
3889,Mozambique,MOZ,2009,1159070,1294432,2453502
3890,Mozambique,MOZ,2010,1188037,1328136,2516173
3891,Mozambique,MOZ,2011,1218970,1361982,2580952
3892,Mozambique,MOZ,2012,1250524,1398645,2649169
3893,Mozambique,MOZ,2013,1284026,1436157,2720183
3894,Mozambique,MOZ,2014,1318582,1476040,2794622
3895,Mozambique,MOZ,2015,1354370,1517406,2871776
3896,Mozambique,MOZ,2016,1389817,1561532,2951349
3897,Mozambique,MOZ,2017,1427797,1609129,3036926
3898,Mozambique,MOZ,2018,1471966,1658987,3130953
3899,Mozambique,MOZ,2019,1522065,1711439,3233504
3900,Myanmar,MMR,1990,2233230,2501127,4734357
3901,Myanmar,MMR,1991,2268397,2547566,4815963
3902,Myanmar,MMR,1992,2302483,2590702,4893185
3903,Myanmar,MMR,1993,2335174,2634482,4969656
3904,Myanmar,MMR,1994,2366317,2675366,5041683
3905,Myanmar,MMR,1995,2397233,2715351,5112584
3906,Myanmar,MMR,1996,2422913,2750228,5173141
3907,Myanmar,MMR,1997,2442354,2779271,5221625
3908,Myanmar,MMR,1998,2457278,2803114,5260392
3909,Myanmar,MMR,1999,2469827,2825826,5295653
3910,Myanmar,MMR,2000,2480329,2848800,5329129
3911,Myanmar,MMR,2001,2489920,2870093,5360013
3912,Myanmar,MMR,2002,2496156,2887927,5384083
3913,Myanmar,MMR,2003,2499751,2902372,5402123
3914,Myanmar,MMR,2004,2502963,2915845,5418808
3915,Myanmar,MMR,2005,2506559,2929707,5436266
3916,Myanmar,MMR,2006,2509926,2940365,5450291
3917,Myanmar,MMR,2007,2512249,2949446,5461695
3918,Myanmar,MMR,2008,2510146,2955772,5465918
3919,Myanmar,MMR,2009,2509979,2962751,5472730
3920,Myanmar,MMR,2010,2515544,2976954,5492498
3921,Myanmar,MMR,2011,2523321,2995778,5519099
3922,Myanmar,MMR,2012,2528732,3019412,5548144
3923,Myanmar,MMR,2013,2537790,3045821,5583611
3924,Myanmar,MMR,2014,2548253,3069834,5618087
3925,Myanmar,MMR,2015,2560760,3099359,5660119
3926,Myanmar,MMR,2016,2571943,3129044,5700987
3927,Myanmar,MMR,2017,2583628,3159575,5743203
3928,Myanmar,MMR,2018,2602512,3192108,5794620
3929,Myanmar,MMR,2019,2625632,3228387,5854019
3930,Namibia,NAM,1990,64644,68292,132936
3931,Namibia,NAM,1991,66733,70754,137487
3932,Namibia,NAM,1992,68904,73280,142184
3933,Namibia,NAM,1993,71101,75809,146910
3934,Namibia,NAM,1994,73370,78377,151747
3935,Namibia,NAM,1995,75619,80885,156504
3936,Namibia,NAM,1996,77871,83335,161206
3937,Namibia,NAM,1997,80104,85505,165609
3938,Namibia,NAM,1998,82220,87539,169759
3939,Namibia,NAM,1999,84236,89479,173715
3940,Namibia,NAM,2000,86189,91424,177613
3941,Namibia,NAM,2001,87965,93262,181227
3942,Namibia,NAM,2002,89543,94947,184490
3943,Namibia,NAM,2003,90926,96511,187437
3944,Namibia,NAM,2004,92230,97985,190215
3945,Namibia,NAM,2005,93527,99466,192993
3946,Namibia,NAM,2006,94750,100867,195617
3947,Namibia,NAM,2007,96039,102258,198297
3948,Namibia,NAM,2008,97294,103705,200999
3949,Namibia,NAM,2009,98631,105284,203915
3950,Namibia,NAM,2010,100002,106962,206964
3951,Namibia,NAM,2011,101555,109029,210584
3952,Namibia,NAM,2012,103166,111406,214572
3953,Namibia,NAM,2013,104896,114030,218926
3954,Namibia,NAM,2014,106642,116578,223220
3955,Namibia,NAM,2015,108439,118849,227288
3956,Namibia,NAM,2016,110039,121065,231104
3957,Namibia,NAM,2017,111694,123214,234908
3958,Namibia,NAM,2018,113527,125170,238697
3959,Namibia,NAM,2019,115543,126993,242536
3960,Nauru,NRU,1990,505,488,993
3961,Nauru,NRU,1991,510,494,1004
3962,Nauru,NRU,1992,514,499,1013
3963,Nauru,NRU,1993,520,505,1025
3964,Nauru,NRU,1994,526,511,1037
3965,Nauru,NRU,1995,531,517,1048
3966,Nauru,NRU,1996,537,524,1061
3967,Nauru,NRU,1997,543,531,1074
3968,Nauru,NRU,1998,548,538,1086
3969,Nauru,NRU,1999,553,544,1097
3970,Nauru,NRU,2000,557,549,1106
3971,Nauru,NRU,2001,560,554,1114
3972,Nauru,NRU,2002,563,557,1120
3973,Nauru,NRU,2003,564,560,1124
3974,Nauru,NRU,2004,564,561,1125
3975,Nauru,NRU,2005,562,560,1122
3976,Nauru,NRU,2006,561,560,1121
3977,Nauru,NRU,2007,559,560,1119
3978,Nauru,NRU,2008,558,560,1118
3979,Nauru,NRU,2009,557,561,1118
3980,Nauru,NRU,2010,556,561,1117
3981,Nauru,NRU,2011,555,561,1116
3982,Nauru,NRU,2012,554,560,1114
3983,Nauru,NRU,2013,552,559,1111
3984,Nauru,NRU,2014,550,558,1108
3985,Nauru,NRU,2015,549,558,1107
3986,Nauru,NRU,2016,549,560,1109
3987,Nauru,NRU,2017,548,562,1110
3988,Nauru,NRU,2018,551,565,1116
3989,Nauru,NRU,2019,554,570,1124
3990,Nepal,NPL,1990,1216918,1171077,2387995
3991,Nepal,NPL,1991,1236294,1190192,2426486
3992,Nepal,NPL,1992,1258437,1211032,2469469
3993,Nepal,NPL,1993,1282913,1233968,2516881
3994,Nepal,NPL,1994,1308837,1258105,2566942
3995,Nepal,NPL,1995,1336410,1284039,2620449
3996,Nepal,NPL,1996,1365628,1315307,2680935
3997,Nepal,NPL,1997,1398522,1353569,2752091
3998,Nepal,NPL,1998,1432284,1394691,2826975
3999,Nepal,NPL,1999,1464492,1436849,2901341
4000,Nepal,NPL,2000,1494583,1474542,2969125
4001,Nepal,NPL,2001,1521731,1509515,3031246
4002,Nepal,NPL,2002,1547631,1545189,3092820
4003,Nepal,NPL,2003,1570321,1581284,3151605
4004,Nepal,NPL,2004,1593496,1617922,3211418
4005,Nepal,NPL,2005,1613905,1654988,3268893
4006,Nepal,NPL,2006,1634250,1693996,3328246
4007,Nepal,NPL,2007,1653913,1734526,3388439
4008,Nepal,NPL,2008,1672459,1775781,3448240
4009,Nepal,NPL,2009,1690122,1816420,3506542
4010,Nepal,NPL,2010,1707163,1855720,3562883
4011,Nepal,NPL,2011,1721199,1887716,3608915
4012,Nepal,NPL,2012,1731345,1911046,3642391
4013,Nepal,NPL,2013,1740001,1931933,3671934
4014,Nepal,NPL,2014,1749832,1954012,3703844
4015,Nepal,NPL,2015,1762636,1982618,3745254
4016,Nepal,NPL,2016,1776514,2017063,3793577
4017,Nepal,NPL,2017,1791392,2054036,3845428
4018,Nepal,NPL,2018,1807539,2090666,3898205
4019,Nepal,NPL,2019,1824786,2130365,3955151
4020,Netherlands,NLD,1990,1035707,1292201,2327908
4021,Netherlands,NLD,1991,1045534,1316209,2361743
4022,Netherlands,NLD,1992,1054915,1338259,2393174
4023,Netherlands,NLD,1993,1063518,1356892,2420410
4024,Netherlands,NLD,1994,1071199,1371806,2443005
4025,Netherlands,NLD,1995,1077533,1382479,2460012
4026,Netherlands,NLD,1996,1083128,1389791,2472919
4027,Netherlands,NLD,1997,1088745,1395663,2484408
4028,Netherlands,NLD,1998,1094568,1400854,2495422
4029,Netherlands,NLD,1999,1099994,1405670,2505664
4030,Netherlands,NLD,2000,1106357,1410319,2516676
4031,Netherlands,NLD,2001,1111076,1408769,2519845
4032,Netherlands,NLD,2002,1113058,1397776,2510834
4033,Netherlands,NLD,2003,1113618,1383551,2497169
4034,Netherlands,NLD,2004,1115103,1371228,2486331
4035,Netherlands,NLD,2005,1118429,1366140,2484569
4036,Netherlands,NLD,2006,1123900,1368623,2492523
4037,Netherlands,NLD,2007,1130288,1372360,2502648
4038,Netherlands,NLD,2008,1137771,1377655,2515426
4039,Netherlands,NLD,2009,1146096,1384371,2530467
4040,Netherlands,NLD,2010,1154693,1392302,2546995
4041,Netherlands,NLD,2011,1165419,1407496,2572915
4042,Netherlands,NLD,2012,1178989,1430584,2609573
4043,Netherlands,NLD,2013,1193110,1457197,2650307
4044,Netherlands,NLD,2014,1205472,1480393,2685865
4045,Netherlands,NLD,2015,1213919,1494101,2708020
4046,Netherlands,NLD,2016,1214241,1495755,2709996
4047,Netherlands,NLD,2017,1213835,1496216,2710051
4048,Netherlands,NLD,2018,1218605,1501469,2720074
4049,Netherlands,NLD,2019,1224935,1507751,2732686
4050,New Zealand,NZL,1990,267428,319967,587395
4051,New Zealand,NZL,1991,270175,326253,596428
4052,New Zealand,NZL,1992,273402,332715,606117
4053,New Zealand,NZL,1993,276857,339050,615907
4054,New Zealand,NZL,1994,280305,345033,625338
4055,New Zealand,NZL,1995,283379,350166,633545
4056,New Zealand,NZL,1996,285919,354124,640043
4057,New Zealand,NZL,1997,287951,356977,644928
4058,New Zealand,NZL,1998,289856,359494,649350
4059,New Zealand,NZL,1999,291838,362327,654165
4060,New Zealand,NZL,2000,294183,365791,659974
4061,New Zealand,NZL,2001,297378,370235,667613
4062,New Zealand,NZL,2002,301746,375493,677239
4063,New Zealand,NZL,2003,306920,381603,688523
4064,New Zealand,NZL,2004,312320,387909,700229
4065,New Zealand,NZL,2005,317299,394144,711443
4066,New Zealand,NZL,2006,321142,399335,720477
4067,New Zealand,NZL,2007,323499,402691,726190
4068,New Zealand,NZL,2008,325039,405158,730197
4069,New Zealand,NZL,2009,326139,407118,733257
4070,New Zealand,NZL,2010,327315,409330,736645
4071,New Zealand,NZL,2011,328688,411741,740429
4072,New Zealand,NZL,2012,330009,413976,743985
4073,New Zealand,NZL,2013,331531,416202,747733
4074,New Zealand,NZL,2014,332979,418320,751299
4075,New Zealand,NZL,2015,334303,420373,754676
4076,New Zealand,NZL,2016,335334,422477,757811
4077,New Zealand,NZL,2017,336163,424445,760608
4078,New Zealand,NZL,2018,337762,426413,764175
4079,New Zealand,NZL,2019,339637,428639,768276
4080,Nicaragua,NIC,1990,203930,224495,428425
4081,Nicaragua,NIC,1991,212105,233656,445761
4082,Nicaragua,NIC,1992,220186,242861,463047
4083,Nicaragua,NIC,1993,228048,251879,479927
4084,Nicaragua,NIC,1994,235706,260841,496547
4085,Nicaragua,NIC,1995,243044,269416,512460
4086,Nicaragua,NIC,1996,250055,277500,527555
4087,Nicaragua,NIC,1997,256834,285524,542358
4088,Nicaragua,NIC,1998,263343,293109,556452
4089,Nicaragua,NIC,1999,269503,300684,570187
4090,Nicaragua,NIC,2000,275695,308061,583756
4091,Nicaragua,NIC,2001,281732,315268,597000
4092,Nicaragua,NIC,2002,287677,322582,610259
4093,Nicaragua,NIC,2003,293428,329730,623158
4094,Nicaragua,NIC,2004,299080,336600,635680
4095,Nicaragua,NIC,2005,304531,343333,647864
4096,Nicaragua,NIC,2006,309868,349738,659606
4097,Nicaragua,NIC,2007,315152,355675,670827
4098,Nicaragua,NIC,2008,320269,361595,681864
4099,Nicaragua,NIC,2009,325377,367458,692835
4100,Nicaragua,NIC,2010,330651,373718,704369
4101,Nicaragua,NIC,2011,336000,380199,716199
4102,Nicaragua,NIC,2012,341330,386942,728272
4103,Nicaragua,NIC,2013,346720,393606,740326
4104,Nicaragua,NIC,2014,351893,400346,752239
4105,Nicaragua,NIC,2015,357270,407139,764409
4106,Nicaragua,NIC,2016,362933,414270,777203
4107,Nicaragua,NIC,2017,368180,421183,789363
4108,Nicaragua,NIC,2018,373532,427454,800986
4109,Nicaragua,NIC,2019,378712,433167,811879
4110,Niger,NER,1990,354706,374751,729457
4111,Niger,NER,1991,367379,388026,755405
4112,Niger,NER,1992,380892,401852,782744
4113,Niger,NER,1993,394752,415915,810667
4114,Niger,NER,1994,409183,430875,840058
4115,Niger,NER,1995,424110,446255,870365
4116,Niger,NER,1996,439493,461907,901400
4117,Niger,NER,1997,455967,479107,935074
4118,Niger,NER,1998,473168,496752,969920
4119,Niger,NER,1999,490900,515172,1006072
4120,Niger,NER,2000,509277,533592,1042869
4121,Niger,NER,2001,528404,552395,1080799
4122,Niger,NER,2002,548166,572084,1120250
4123,Niger,NER,2003,568691,592303,1160994
4124,Niger,NER,2004,590066,613592,1203658
4125,Niger,NER,2005,612766,636096,1248862
4126,Niger,NER,2006,636729,660383,1297112
4127,Niger,NER,2007,662127,685855,1347982
4128,Niger,NER,2008,689001,713295,1402296
4129,Niger,NER,2009,716857,741548,1458405
4130,Niger,NER,2010,745548,771239,1516787
4131,Niger,NER,2011,774890,801879,1576769
4132,Niger,NER,2012,805976,834366,1640342
4133,Niger,NER,2013,838539,868000,1706539
4134,Niger,NER,2014,872108,903686,1775794
4135,Niger,NER,2015,906577,940615,1847192
4136,Niger,NER,2016,941420,979352,1920772
4137,Niger,NER,2017,978070,1019737,1997807
4138,Niger,NER,2018,1016946,1060914,2077860
4139,Niger,NER,2019,1058604,1103248,2161852
4140,Nigeria,NGA,1990,4282336,4308719,8591055
4141,Nigeria,NGA,1991,4413487,4433912,8847399
4142,Nigeria,NGA,1992,4553374,4567426,9120800
4143,Nigeria,NGA,1993,4701881,4708252,9410133
4144,Nigeria,NGA,1994,4857530,4856187,9713717
4145,Nigeria,NGA,1995,5020408,5009674,10030082
4146,Nigeria,NGA,1996,5198689,5201821,10400510
4147,Nigeria,NGA,1997,5398278,5448992,10847270
4148,Nigeria,NGA,1998,5609611,5722174,11331785
4149,Nigeria,NGA,1999,5822363,5990496,11812859
4150,Nigeria,NGA,2000,6024310,6217702,12242012
4151,Nigeria,NGA,2001,6216053,6414224,12630277
4152,Nigeria,NGA,2002,6406665,6612712,13019377
4153,Nigeria,NGA,2003,6595756,6815057,13410813
4154,Nigeria,NGA,2004,6781284,7022680,13803964
4155,Nigeria,NGA,2005,6962996,7237378,14200374
4156,Nigeria,NGA,2006,7140319,7447547,14587866
4157,Nigeria,NGA,2007,7311626,7646307,14957933
4158,Nigeria,NGA,2008,7475790,7835044,15310834
4159,Nigeria,NGA,2009,7632310,8017090,15649400
4160,Nigeria,NGA,2010,7778529,8197876,15976405
4161,Nigeria,NGA,2011,7902813,8356225,16259038
4162,Nigeria,NGA,2012,8006538,8490207,16496745
4163,Nigeria,NGA,2013,8110147,8627642,16737789
4164,Nigeria,NGA,2014,8236136,8803867,17040003
4165,Nigeria,NGA,2015,8408167,9058496,17466663
4166,Nigeria,NGA,2016,8621704,9377920,17999624
4167,Nigeria,NGA,2017,8851065,9712608,18563673
4168,Nigeria,NGA,2018,9089325,10053046,19142371
4169,Nigeria,NGA,2019,9336823,10398270,19735093
4170,Niue,NIU,1990,122,128,250
4171,Niue,NIU,1991,121,128,249
4172,Niue,NIU,1992,120,127,247
4173,Niue,NIU,1993,120,127,247
4174,Niue,NIU,1994,119,127,246
4175,Niue,NIU,1995,119,126,245
4176,Niue,NIU,1996,117,125,242
4177,Niue,NIU,1997,115,123,238
4178,Niue,NIU,1998,112,120,232
4179,Niue,NIU,1999,109,117,226
4180,Niue,NIU,2000,106,114,220
4181,Niue,NIU,2001,102,110,212
4182,Niue,NIU,2002,99,106,205
4183,Niue,NIU,2003,96,103,199
4184,Niue,NIU,2004,93,100,193
4185,Niue,NIU,2005,91,98,189
4186,Niue,NIU,2006,89,96,185
4187,Niue,NIU,2007,88,95,183
4188,Niue,NIU,2008,88,95,183
4189,Niue,NIU,2009,88,95,183
4190,Niue,NIU,2010,88,96,184
4191,Niue,NIU,2011,89,96,185
4192,Niue,NIU,2012,89,97,186
4193,Niue,NIU,2013,90,98,188
4194,Niue,NIU,2014,90,98,188
4195,Niue,NIU,2015,91,99,190
4196,Niue,NIU,2016,92,100,192
4197,Niue,NIU,2017,92,100,192
4198,Niue,NIU,2018,92,101,193
4199,Niue,NIU,2019,93,101,194
4200,North America (WB),,1990,19548921,22529224,42078145
4201,North America (WB),,1991,19893550,23011756,42905306
4202,North America (WB),,1992,20242854,23489554,43732408
4203,North America (WB),,1993,20589996,23952123,44542119
4204,North America (WB),,1994,20937744,24396704,45334448
4205,North America (WB),,1995,21276799,24816562,46093361
4206,North America (WB),,1996,21706380,25403574,47109954
4207,North America (WB),,1997,22264830,26231175,48496005
4208,North America (WB),,1998,22859842,27131470,49991312
4209,North America (WB),,1999,23400392,27931866,51332258
4210,North America (WB),,2000,23775729,28446096,52221825
4211,North America (WB),,2001,23986319,28664490,52650809
4212,North America (WB),,2002,24109456,28736215,52845671
4213,North America (WB),,2003,24188094,28727779,52915873
4214,North America (WB),,2004,24274787,28725579,53000366
4215,North America (WB),,2005,24404251,28789626,53193877
4216,North America (WB),,2006,24621156,28941084,53562240
4217,North America (WB),,2007,24902769,29119673,54022442
4218,North America (WB),,2008,25206422,29303243,54509665
4219,North America (WB),,2009,25482580,29473984,54956564
4220,North America (WB),,2010,25674940,29598033,55272973
4221,North America (WB),,2011,25741614,29625054,55366668
4222,North America (WB),,2012,25704103,29541008,55245111
4223,North America (WB),,2013,25627932,29427788,55055720
4224,North America (WB),,2014,25582496,29358266,54940762
4225,North America (WB),,2015,25628541,29404311,55032852
4226,North America (WB),,2016,25841393,29518453,55359846
4227,North America (WB),,2017,26068711,29658900,55727611
4228,North America (WB),,2018,26375825,30187433,56563258
4229,North America (WB),,2019,26883882,31136628,58020510
4230,North Korea,PRK,1990,993632,1222290,2215922
4231,North Korea,PRK,1991,1013068,1244364,2257432
4232,North Korea,PRK,1992,1033091,1266798,2299889
4233,North Korea,PRK,1993,1053628,1288867,2342495
4234,North Korea,PRK,1994,1075393,1311472,2386865
4235,North Korea,PRK,1995,1096117,1330918,2427035
4236,North Korea,PRK,1996,1117552,1349506,2467058
4237,North Korea,PRK,1997,1140301,1370571,2510872
4238,North Korea,PRK,1998,1163303,1390968,2554271
4239,North Korea,PRK,1999,1185147,1410297,2595444
4240,North Korea,PRK,2000,1205180,1427169,2632349
4241,North Korea,PRK,2001,1223580,1440475,2664055
4242,North Korea,PRK,2002,1240835,1453652,2694487
4243,North Korea,PRK,2003,1259260,1468014,2727274
4244,North Korea,PRK,2004,1278466,1484187,2762653
4245,North Korea,PRK,2005,1296475,1498620,2795095
4246,North Korea,PRK,2006,1313228,1511902,2825130
4247,North Korea,PRK,2007,1328008,1522734,2850742
4248,North Korea,PRK,2008,1341464,1532405,2873869
4249,North Korea,PRK,2009,1354370,1541105,2895475
4250,North Korea,PRK,2010,1366041,1550507,2916548
4251,North Korea,PRK,2011,1378348,1561069,2939417
4252,North Korea,PRK,2012,1390171,1571316,2961487
4253,North Korea,PRK,2013,1402630,1581640,2984270
4254,North Korea,PRK,2014,1413890,1591423,3005313
4255,North Korea,PRK,2015,1424517,1600228,3024745
4256,North Korea,PRK,2016,1431940,1605984,3037924
4257,North Korea,PRK,2017,1438771,1610936,3049707
4258,North Korea,PRK,2018,1447649,1619930,3067579
4259,North Korea,PRK,2019,1457482,1632746,3090228
4260,North Macedonia,MKD,1990,103594,119791,223385
4261,North Macedonia,MKD,1991,104021,120592,224613
4262,North Macedonia,MKD,1992,104240,121221,225461
4263,North Macedonia,MKD,1993,103989,121488,225477
4264,North Macedonia,MKD,1994,103739,121764,225503
4265,North Macedonia,MKD,1995,103968,122420,226388
4266,North Macedonia,MKD,1996,104770,123373,228143
4267,North Macedonia,MKD,1997,109472,127328,236800
4268,North Macedonia,MKD,1998,114725,131686,246411
4269,North Macedonia,MKD,1999,110229,128623,238852
4270,North Macedonia,MKD,2000,105297,125149,230446
4271,North Macedonia,MKD,2001,106993,126636,233629
4272,North Macedonia,MKD,2002,109368,128743,238111
4273,North Macedonia,MKD,2003,110396,129655,240051
4274,North Macedonia,MKD,2004,110808,130228,241036
4275,North Macedonia,MKD,2005,111205,130699,241904
4276,North Macedonia,MKD,2006,111607,131178,242785
4277,North Macedonia,MKD,2007,111913,131441,243354
4278,North Macedonia,MKD,2008,112113,131646,243759
4279,North Macedonia,MKD,2009,112257,131789,244046
4280,North Macedonia,MKD,2010,112338,132059,244397
4281,North Macedonia,MKD,2011,112520,132439,244959
4282,North Macedonia,MKD,2012,112785,132876,245661
4283,North Macedonia,MKD,2013,112860,133134,245994
4284,North Macedonia,MKD,2014,112826,133368,246194
4285,North Macedonia,MKD,2015,113101,133780,246881
4286,North Macedonia,MKD,2016,113414,134056,247470
4287,North Macedonia,MKD,2017,113564,134212,247776
4288,North Macedonia,MKD,2018,113689,134539,248228
4289,North Macedonia,MKD,2019,113729,135026,248755
4290,Northern Ireland,,1990,108852,134904,243756
4291,Northern Ireland,,1991,109604,135810,245414
4292,Northern Ireland,,1992,110407,136861,247268
4293,Northern Ireland,,1993,111274,137985,249259
4294,Northern Ireland,,1994,112095,139205,251300
4295,Northern Ireland,,1995,113015,140501,253516
4296,Northern Ireland,,1996,115046,144173,259219
4297,Northern Ireland,,1997,118569,151031,269600
4298,Northern Ireland,,1998,122594,159022,281616
4299,Northern Ireland,,1999,126153,165955,292108
4300,Northern Ireland,,2000,128278,169718,297996
4301,Northern Ireland,,2001,129415,171187,300602
4302,Northern Ireland,,2002,130583,172608,303191
4303,Northern Ireland,,2003,131727,174029,305756
4304,Northern Ireland,,2004,132839,175356,308195
4305,Northern Ireland,,2005,133869,176658,310527
4306,Northern Ireland,,2006,134929,177985,312914
4307,Northern Ireland,,2007,136023,179368,315391
4308,Northern Ireland,,2008,137061,180697,317758
4309,Northern Ireland,,2009,138068,181980,320048
4310,Northern Ireland,,2010,139093,183185,322278
4311,Northern Ireland,,2011,139524,183112,322636
4312,Northern Ireland,,2012,139135,181264,320399
4313,Northern Ireland,,2013,138487,178694,317181
4314,Northern Ireland,,2014,138004,176571,314575
4315,Northern Ireland,,2015,138201,175875,314076
4316,Northern Ireland,,2016,138384,175281,313665
4317,Northern Ireland,,2017,138610,174874,313484
4318,Northern Ireland,,2018,139388,175795,315183
4319,Northern Ireland,,2019,140103,176926,317029
4320,Northern Mariana Islands,MNP,1990,2459,2247,4706
4321,Northern Mariana Islands,MNP,1991,2523,2375,4898
4322,Northern Mariana Islands,MNP,1992,2508,2400,4908
4323,Northern Mariana Islands,MNP,1993,2469,2366,4835
4324,Northern Mariana Islands,MNP,1994,2461,2352,4813
4325,Northern Mariana Islands,MNP,1995,2520,2429,4949
4326,Northern Mariana Islands,MNP,1996,2663,2631,5294
4327,Northern Mariana Islands,MNP,1997,2863,2959,5822
4328,Northern Mariana Islands,MNP,1998,3089,3399,6488
4329,Northern Mariana Islands,MNP,1999,3289,3879,7168
4330,Northern Mariana Islands,MNP,2000,3420,4230,7650
4331,Northern Mariana Islands,MNP,2001,3446,4226,7672
4332,Northern Mariana Islands,MNP,2002,3394,3930,7324
4333,Northern Mariana Islands,MNP,2003,3315,3595,6910
4334,Northern Mariana Islands,MNP,2004,3243,3384,6627
4335,Northern Mariana Islands,MNP,2005,3196,3293,6489
4336,Northern Mariana Islands,MNP,2006,3171,3263,6434
4337,Northern Mariana Islands,MNP,2007,3155,3234,6389
4338,Northern Mariana Islands,MNP,2008,3132,3178,6310
4339,Northern Mariana Islands,MNP,2009,3093,3084,6177
4340,Northern Mariana Islands,MNP,2010,3029,2976,6005
4341,Northern Mariana Islands,MNP,2011,2947,2881,5828
4342,Northern Mariana Islands,MNP,2012,2857,2809,5666
4343,Northern Mariana Islands,MNP,2013,2769,2762,5531
4344,Northern Mariana Islands,MNP,2014,2692,2730,5422
4345,Northern Mariana Islands,MNP,2015,2631,2699,5330
4346,Northern Mariana Islands,MNP,2016,2581,2652,5233
4347,Northern Mariana Islands,MNP,2017,2541,2594,5135
4348,Northern Mariana Islands,MNP,2018,2506,2535,5041
4349,Northern Mariana Islands,MNP,2019,2467,2485,4952
4350,Norway,NOR,1990,296097,361990,658087
4351,Norway,NOR,1991,296383,363931,660314
4352,Norway,NOR,1992,296765,365580,662345
4353,Norway,NOR,1993,297342,366988,664330
4354,Norway,NOR,1994,298173,368246,666419
4355,Norway,NOR,1995,299236,369469,668705
4356,Norway,NOR,1996,300371,368982,669353
4357,Norway,NOR,1997,301643,366133,667776
4358,Norway,NOR,1998,303110,362583,665693
4359,Norway,NOR,1999,304941,360030,664971
4360,Norway,NOR,2000,307238,360171,667409
4361,Norway,NOR,2001,310508,363057,673565
4362,Norway,NOR,2002,314823,367225,682048
4363,Norway,NOR,2003,319525,371956,691481
4364,Norway,NOR,2004,323980,376549,700529
4365,Norway,NOR,2005,327696,380254,707950
4366,Norway,NOR,2006,330915,383013,713928
4367,Norway,NOR,2007,334338,385543,719881
4368,Norway,NOR,2008,338122,388199,726321
4369,Norway,NOR,2009,342301,391454,733755
4370,Norway,NOR,2010,346922,395647,742569
4371,Norway,NOR,2011,351770,400639,752409
4372,Norway,NOR,2012,356506,405999,762505
4373,Norway,NOR,2013,361087,411568,772655
4374,Norway,NOR,2014,365567,417189,782756
4375,Norway,NOR,2015,369803,422714,792517
4376,Norway,NOR,2016,373825,429102,802927
4377,Norway,NOR,2017,377697,434689,812386
4378,Norway,NOR,2018,380849,438063,818912
4379,Norway,NOR,2019,383061,440329,823390
4380,OECD Countries,,1990,68407981,80817700,149225681
4381,OECD Countries,,1991,68939478,81638901,150578379
4382,OECD Countries,,1992,69475286,82469407,151944693
4383,OECD Countries,,1993,70013174,83287893,153301067
4384,OECD Countries,,1994,70555327,84091384,154646711
4385,OECD Countries,,1995,71101494,84879614,155981108
4386,OECD Countries,,1996,71769763,85921208,157690971
4387,OECD Countries,,1997,72607290,87327485,159934775
4388,OECD Countries,,1998,73503670,88866298,162369968
4389,OECD Countries,,1999,74358629,90291862,164650491
4390,OECD Countries,,2000,75045490,91358429,166403919
4391,OECD Countries,,2001,75585408,92066866,167652274
4392,OECD Countries,,2002,76067456,92619605,168687061
4393,OECD Countries,,2003,76510528,93088421,169598949
4394,OECD Countries,,2004,76964140,93559269,170523409
4395,OECD Countries,,2005,77434239,94092984,171527223
4396,OECD Countries,,2006,77993230,94777434,172770664
4397,OECD Countries,,2007,78634053,95574494,174208547
4398,OECD Countries,,2008,79298939,96399593,175698532
4399,OECD Countries,,2009,79906758,97161571,177068329
4400,OECD Countries,,2010,80390829,97766361,178157190
4401,OECD Countries,,2011,80728326,98171151,178899477
4402,OECD Countries,,2012,80981129,98418808,179399937
4403,OECD Countries,,2013,81215283,98614217,179829500
4404,OECD Countries,,2014,81484780,98846303,180331083
4405,OECD Countries,,2015,81826155,99197894,181024049
4406,OECD Countries,,2016,82306385,99459500,181765885
4407,OECD Countries,,2017,82790545,99719630,182510175
4408,OECD Countries,,2018,83341440,100416452,183757892
4409,OECD Countries,,2019,84090463,101449003,185539466
4410,Oman,OMN,1990,139808,98982,238790
4411,Oman,OMN,1991,143846,102496,246342
4412,Oman,OMN,1992,148936,106027,254963
4413,Oman,OMN,1993,152776,109384,262160
4414,Oman,OMN,1994,153777,113090,266867
4415,Oman,OMN,1995,154334,117002,271336
4416,Oman,OMN,1996,157258,121022,278280
4417,Oman,OMN,1997,162296,124877,287173
4418,Oman,OMN,1998,165500,128411,293911
4419,Oman,OMN,1999,164181,131892,296073
4420,Oman,OMN,2000,162269,135556,297825
4421,Oman,OMN,2001,164970,139254,304224
4422,Oman,OMN,2002,171192,142655,313847
4423,Oman,OMN,2003,173602,145465,319067
4424,Oman,OMN,2004,168777,147513,316290
4425,Oman,OMN,2005,165323,149489,314812
4426,Oman,OMN,2006,171556,151788,323344
4427,Oman,OMN,2007,184265,154432,338697
4428,Oman,OMN,2008,192733,157376,350109
4429,Oman,OMN,2009,197796,161030,358826
4430,Oman,OMN,2010,213952,166354,380306
4431,Oman,OMN,2011,255009,174070,429079
4432,Oman,OMN,2012,307993,183189,491182
4433,Oman,OMN,2013,333715,192340,526055
4434,Oman,OMN,2014,342207,200799,543006
4435,Oman,OMN,2015,357000,208775,565775
4436,Oman,OMN,2016,384016,215633,599649
4437,Oman,OMN,2017,396524,221293,617817
4438,Oman,OMN,2018,393280,228337,621617
4439,Oman,OMN,2019,396239,236751,632990
4440,Pakistan,PAK,1990,6297619,5528523,11826142
4441,Pakistan,PAK,1991,6424718,5641961,12066679
4442,Pakistan,PAK,1992,6557887,5763254,12321141
4443,Pakistan,PAK,1993,6694614,5892368,12586982
4444,Pakistan,PAK,1994,6836504,6030921,12867425
4445,Pakistan,PAK,1995,6982475,6180560,13163035
4446,Pakistan,PAK,1996,7135499,6343830,13479329
4447,Pakistan,PAK,1997,7294332,6528085,13822417
4448,Pakistan,PAK,1998,7460666,6725914,14186580
4449,Pakistan,PAK,1999,7637116,6931101,14568217
4450,Pakistan,PAK,2000,7824016,7134888,14958904
4451,Pakistan,PAK,2001,8024271,7344481,15368752
4452,Pakistan,PAK,2002,8232340,7565794,15798134
4453,Pakistan,PAK,2003,8450044,7796366,16246410
4454,Pakistan,PAK,2004,8676314,8039231,16715545
4455,Pakistan,PAK,2005,8909654,8282632,17192286
4456,Pakistan,PAK,2006,9148749,8531481,17680230
4457,Pakistan,PAK,2007,9397305,8783417,18180722
4458,Pakistan,PAK,2008,9655816,9040148,18695964
4459,Pakistan,PAK,2009,9926441,9306642,19233083
4460,Pakistan,PAK,2010,10208010,9578754,19786764
4461,Pakistan,PAK,2011,10512271,9859595,20371866
4462,Pakistan,PAK,2012,10846764,10140102,20986866
4463,Pakistan,PAK,2013,11186894,10427401,21614295
4464,Pakistan,PAK,2014,11531455,10724442,22255897
4465,Pakistan,PAK,2015,11855948,11036363,22892311
4466,Pakistan,PAK,2016,12167900,11357535,23525435
4467,Pakistan,PAK,2017,12482582,11691621,24174203
4468,Pakistan,PAK,2018,12827759,12071277,24899036
4469,Pakistan,PAK,2019,13204673,12517328,25722001
4470,Palau,PLW,1990,847,839,1686
4471,Palau,PLW,1991,861,875,1736
4472,Palau,PLW,1992,879,911,1790
4473,Palau,PLW,1993,900,945,1845
4474,Palau,PLW,1994,928,976,1904
4475,Palau,PLW,1995,962,1000,1962
4476,Palau,PLW,1996,1005,1015,2020
4477,Palau,PLW,1997,1054,1023,2077
4478,Palau,PLW,1998,1105,1029,2134
4479,Palau,PLW,1999,1155,1034,2189
4480,Palau,PLW,2000,1197,1042,2239
4481,Palau,PLW,2001,1226,1054,2280
4482,Palau,PLW,2002,1242,1070,2312
4483,Palau,PLW,2003,1247,1087,2334
4484,Palau,PLW,2004,1241,1101,2342
4485,Palau,PLW,2005,1225,1110,2335
4486,Palau,PLW,2006,1202,1109,2311
4487,Palau,PLW,2007,1173,1101,2274
4488,Palau,PLW,2008,1144,1089,2233
4489,Palau,PLW,2009,1116,1073,2189
4490,Palau,PLW,2010,1091,1056,2147
4491,Palau,PLW,2011,1073,1040,2113
4492,Palau,PLW,2012,1065,1028,2093
4493,Palau,PLW,2013,1068,1022,2090
4494,Palau,PLW,2014,1077,1021,2098
4495,Palau,PLW,2015,1089,1023,2112
4496,Palau,PLW,2016,1098,1024,2122
4497,Palau,PLW,2017,1106,1027,2133
4498,Palau,PLW,2018,1114,1030,2144
4499,Palau,PLW,2019,1123,1033,2156
4500,Palestine,PSE,1990,160990,163622,324612
4501,Palestine,PSE,1991,167039,169367,336406
4502,Palestine,PSE,1992,173421,175408,348829
4503,Palestine,PSE,1993,180080,181786,361866
4504,Palestine,PSE,1994,187082,188428,375510
4505,Palestine,PSE,1995,194487,195388,389875
4506,Palestine,PSE,1996,202827,202905,405732
4507,Palestine,PSE,1997,212562,211124,423686
4508,Palestine,PSE,1998,223300,220071,443371
4509,Palestine,PSE,1999,234451,229537,463988
4510,Palestine,PSE,2000,245179,239184,484363
4511,Palestine,PSE,2001,255514,249074,504588
4512,Palestine,PSE,2002,266009,259410,525419
4513,Palestine,PSE,2003,276523,270167,546690
4514,Palestine,PSE,2004,287116,280958,568074
4515,Palestine,PSE,2005,297671,291782,589453
4516,Palestine,PSE,2006,308140,302460,610600
4517,Palestine,PSE,2007,318288,312909,631197
4518,Palestine,PSE,2008,328075,322962,651037
4519,Palestine,PSE,2009,337385,332467,669852
4520,Palestine,PSE,2010,346495,341794,688289
4521,Palestine,PSE,2011,355229,350303,705532
4522,Palestine,PSE,2012,362497,358218,720715
4523,Palestine,PSE,2013,369054,365443,734497
4524,Palestine,PSE,2014,374976,372291,747267
4525,Palestine,PSE,2015,380550,379329,759879
4526,Palestine,PSE,2016,383834,385986,769820
4527,Palestine,PSE,2017,388154,393167,781321
4528,Palestine,PSE,2018,395953,401933,797886
4529,Palestine,PSE,2019,404347,411508,815855
4530,Panama,PAN,1990,130459,133789,264248
4531,Panama,PAN,1991,133577,137143,270720
4532,Panama,PAN,1992,136593,140436,277029
4533,Panama,PAN,1993,139579,143772,283351
4534,Panama,PAN,1994,142510,147119,289629
4535,Panama,PAN,1995,145409,150488,295897
4536,Panama,PAN,1996,148287,153887,302174
4537,Panama,PAN,1997,151133,157320,308453
4538,Panama,PAN,1998,153942,160802,314744
4539,Panama,PAN,1999,156860,164314,321174
4540,Panama,PAN,2000,159881,167864,327745
4541,Panama,PAN,2001,163011,171581,334592
4542,Panama,PAN,2002,166327,175415,341742
4543,Panama,PAN,2003,169590,179272,348862
4544,Panama,PAN,2004,172926,183140,356066
4545,Panama,PAN,2005,176311,187032,363343
4546,Panama,PAN,2006,179755,190948,370703
4547,Panama,PAN,2007,183195,194754,377949
4548,Panama,PAN,2008,186699,198600,385299
4549,Panama,PAN,2009,190134,202592,392726
4550,Panama,PAN,2010,193641,206567,400208
4551,Panama,PAN,2011,197209,210807,408016
4552,Panama,PAN,2012,200716,215153,415869
4553,Panama,PAN,2013,204326,219573,423899
4554,Panama,PAN,2014,207908,223991,431899
4555,Panama,PAN,2015,212101,228836,440937
4556,Panama,PAN,2016,217758,234723,452481
4557,Panama,PAN,2017,223826,240829,464655
4558,Panama,PAN,2018,228091,245850,473941
4559,Panama,PAN,2019,231294,250288,481582
4560,Papua New Guinea,PNG,1990,231194,216636,447830
4561,Papua New Guinea,PNG,1991,237236,222924,460160
4562,Papua New Guinea,PNG,1992,243541,229492,473033
4563,Papua New Guinea,PNG,1993,250274,236221,486495
4564,Papua New Guinea,PNG,1994,257307,243358,500665
4565,Papua New Guinea,PNG,1995,265005,250950,515955
4566,Papua New Guinea,PNG,1996,272991,258926,531917
4567,Papua New Guinea,PNG,1997,281469,267123,548592
4568,Papua New Guinea,PNG,1998,290116,275642,565758
4569,Papua New Guinea,PNG,1999,299438,284671,584109
4570,Papua New Guinea,PNG,2000,309301,293958,603259
4571,Papua New Guinea,PNG,2001,319774,303843,623617
4572,Papua New Guinea,PNG,2002,330947,314158,645105
4573,Papua New Guinea,PNG,2003,342585,324907,667492
4574,Papua New Guinea,PNG,2004,354551,336197,690748
4575,Papua New Guinea,PNG,2005,366638,347732,714370
4576,Papua New Guinea,PNG,2006,378914,359398,738312
4577,Papua New Guinea,PNG,2007,391559,371758,763317
4578,Papua New Guinea,PNG,2008,404379,384180,788559
4579,Papua New Guinea,PNG,2009,417525,396886,814411
4580,Papua New Guinea,PNG,2010,430729,409730,840459
4581,Papua New Guinea,PNG,2011,444105,422442,866547
4582,Papua New Guinea,PNG,2012,457423,435105,892528
4583,Papua New Guinea,PNG,2013,470922,447616,918538
4584,Papua New Guinea,PNG,2014,484324,460340,944664
4585,Papua New Guinea,PNG,2015,498104,473453,971557
4586,Papua New Guinea,PNG,2016,510772,487372,998144
4587,Papua New Guinea,PNG,2017,523598,501240,1024838
4588,Papua New Guinea,PNG,2018,537852,515854,1053706
4589,Papua New Guinea,PNG,2019,552950,530870,1083820
4590,Paraguay,PRY,1990,245607,298423,544030
4591,Paraguay,PRY,1991,253427,308472,561899
4592,Paraguay,PRY,1992,261144,318580,579724
4593,Paraguay,PRY,1993,269062,328609,597671
4594,Paraguay,PRY,1994,276986,338576,615562
4595,Paraguay,PRY,1995,284905,348373,633278
4596,Paraguay,PRY,1996,292821,357808,650629
4597,Paraguay,PRY,1997,300985,366797,667782
4598,Paraguay,PRY,1998,308907,375638,684545
4599,Paraguay,PRY,1999,316869,384579,701448
4600,Paraguay,PRY,2000,324681,393973,718654
4601,Paraguay,PRY,2001,332475,403983,736458
4602,Paraguay,PRY,2002,340405,414158,754563
4603,Paraguay,PRY,2003,348266,424778,773044
4604,Paraguay,PRY,2004,355877,434830,790707
4605,Paraguay,PRY,2005,363597,444904,808501
4606,Paraguay,PRY,2006,371072,454603,825675
4607,Paraguay,PRY,2007,378658,464199,842857
4608,Paraguay,PRY,2008,386217,473498,859715
4609,Paraguay,PRY,2009,393612,482894,876506
4610,Paraguay,PRY,2010,401064,492437,893501
4611,Paraguay,PRY,2011,408427,502921,911348
4612,Paraguay,PRY,2012,416202,514578,930780
4613,Paraguay,PRY,2013,423946,526596,950542
4614,Paraguay,PRY,2014,431573,538462,970035
4615,Paraguay,PRY,2015,438912,549486,988398
4616,Paraguay,PRY,2016,445809,559275,1005084
4617,Paraguay,PRY,2017,452609,568685,1021294
4618,Paraguay,PRY,2018,459425,577825,1037250
4619,Paraguay,PRY,2019,466343,586544,1052887
4620,Peru,PER,1990,1326312,1415995,2742307
4621,Peru,PER,1991,1354151,1449353,2803504
4622,Peru,PER,1992,1381623,1482212,2863835
4623,Peru,PER,1993,1409663,1513968,2923631
4624,Peru,PER,1994,1437425,1544983,2982408
4625,Peru,PER,1995,1465686,1575077,3040763
4626,Peru,PER,1996,1492997,1604285,3097282
4627,Peru,PER,1997,1520277,1634214,3154491
4628,Peru,PER,1998,1546433,1662770,3209203
4629,Peru,PER,1999,1572467,1691670,3264137
4630,Peru,PER,2000,1597890,1720316,3318206
4631,Peru,PER,2001,1623364,1748534,3371898
4632,Peru,PER,2002,1647535,1775605,3423140
4633,Peru,PER,2003,1672501,1803163,3475664
4634,Peru,PER,2004,1695633,1830125,3525758
4635,Peru,PER,2005,1718469,1858196,3576665
4636,Peru,PER,2006,1739770,1884997,3624767
4637,Peru,PER,2007,1758662,1909949,3668611
4638,Peru,PER,2008,1776310,1934893,3711203
4639,Peru,PER,2009,1796435,1960771,3757206
4640,Peru,PER,2010,1820980,1990199,3811179
4641,Peru,PER,2011,1852665,2027303,3879968
4642,Peru,PER,2012,1892979,2073599,3966578
4643,Peru,PER,2013,1943572,2132711,4076283
4644,Peru,PER,2014,1991753,2187379,4179132
4645,Peru,PER,2015,2030939,2232390,4263329
4646,Peru,PER,2016,2062352,2271390,4333742
4647,Peru,PER,2017,2101541,2317277,4418818
4648,Peru,PER,2018,2131875,2353885,4485760
4649,Peru,PER,2019,2152278,2382928,4535206
4650,Philippines,PHL,1990,3341179,3698409,7039588
4651,Philippines,PHL,1991,3422642,3791096,7213738
4652,Philippines,PHL,1992,3504268,3885900,7390168
4653,Philippines,PHL,1993,3585964,3982120,7568084
4654,Philippines,PHL,1994,3667619,4079685,7747304
4655,Philippines,PHL,1995,3748964,4178341,7927305
4656,Philippines,PHL,1996,3825764,4276058,8101822
4657,Philippines,PHL,1997,3897594,4372457,8270051
4658,Philippines,PHL,1998,3968050,4469229,8437279
4659,Philippines,PHL,1999,4042318,4567375,8609693
4660,Philippines,PHL,2000,4124636,4668306,8792942
4661,Philippines,PHL,2001,4213600,4771229,8984829
4662,Philippines,PHL,2002,4304583,4875756,9180339
4663,Philippines,PHL,2003,4397876,4981939,9379815
4664,Philippines,PHL,2004,4493320,5089879,9583199
4665,Philippines,PHL,2005,4590296,5199162,9789458
4666,Philippines,PHL,2006,4688187,5307615,9995802
4667,Philippines,PHL,2007,4786017,5414411,10200428
4668,Philippines,PHL,2008,4881193,5519785,10400978
4669,Philippines,PHL,2009,4973644,5623824,10597468
4670,Philippines,PHL,2010,5063650,5726953,10790603
4671,Philippines,PHL,2011,5153853,5828203,10982056
4672,Philippines,PHL,2012,5244545,5927013,11171558
4673,Philippines,PHL,2013,5334668,6024127,11358795
4674,Philippines,PHL,2014,5423426,6121708,11545134
4675,Philippines,PHL,2015,5512039,6221002,11733041
4676,Philippines,PHL,2016,5592148,6327617,11919765
4677,Philippines,PHL,2017,5672816,6436247,12109063
4678,Philippines,PHL,2018,5770402,6545612,12316014
4679,Philippines,PHL,2019,5880800,6658470,12539270
4680,Poland,POL,1990,1869079,2088541,3957620
4681,Poland,POL,1991,1881861,2103825,3985686
4682,Poland,POL,1992,1892716,2118298,4011014
4683,Poland,POL,1993,1903190,2132224,4035414
4684,Poland,POL,1994,1912131,2144953,4057084
4685,Poland,POL,1995,1919185,2156340,4075525
4686,Poland,POL,1996,1924170,2165662,4089832
4687,Poland,POL,1997,1925911,2172705,4098616
4688,Poland,POL,1998,1925980,2178411,4104391
4689,Poland,POL,1999,1924388,2183098,4107486
4690,Poland,POL,2000,1922612,2187182,4109794
4691,Poland,POL,2001,1919191,2187208,4106399
4692,Poland,POL,2002,1912700,2180347,4093047
4693,Poland,POL,2003,1904552,2170839,4075391
4694,Poland,POL,2004,1896487,2162497,4058984
4695,Poland,POL,2005,1890923,2159624,4050547
4696,Poland,POL,2006,1887438,2161260,4048698
4697,Poland,POL,2007,1884159,2163484,4047643
4698,Poland,POL,2008,1881376,2165849,4047225
4699,Poland,POL,2009,1878647,2167657,4046304
4700,Poland,POL,2010,1876112,2168697,4044809
4701,Poland,POL,2011,1873408,2169361,4042769
4702,Poland,POL,2012,1869772,2168629,4038401
4703,Poland,POL,2013,1866344,2167783,4034127
4704,Poland,POL,2014,1863319,2166466,4029785
4705,Poland,POL,2015,1860904,2164786,4025690
4706,Poland,POL,2016,1859921,2157824,4017745
4707,Poland,POL,2017,1859152,2151371,4010523
4708,Poland,POL,2018,1864732,2167108,4031840
4709,Poland,POL,2019,1878037,2204450,4082487
4710,Portugal,PRT,1990,765305,1082874,1848179
4711,Portugal,PRT,1991,766573,1085549,1852122
4712,Portugal,PRT,1992,768785,1090088,1858873
4713,Portugal,PRT,1993,771582,1095999,1867581
4714,Portugal,PRT,1994,775166,1102378,1877544
4715,Portugal,PRT,1995,778778,1109163,1887941
4716,Portugal,PRT,1996,782157,1121841,1903998
4717,Portugal,PRT,1997,785231,1143302,1928533
4718,Portugal,PRT,1998,788299,1167536,1955835
4719,Portugal,PRT,1999,791509,1188853,1980362
4720,Portugal,PRT,2000,795050,1201830,1996880
4721,Portugal,PRT,2001,798644,1202638,2001282
4722,Portugal,PRT,2002,802877,1194879,1997756
4723,Portugal,PRT,2003,806634,1183998,1990632
4724,Portugal,PRT,2004,809463,1174711,1984174
4725,Portugal,PRT,2005,810960,1172480,1983440
4726,Portugal,PRT,2006,811047,1177631,1988678
4727,Portugal,PRT,2007,810123,1184304,1994427
4728,Portugal,PRT,2008,808736,1191590,2000326
4729,Portugal,PRT,2009,807352,1197873,2005225
4730,Portugal,PRT,2010,805964,1201232,2007196
4731,Portugal,PRT,2011,804726,1195946,2000672
4732,Portugal,PRT,2012,803375,1180923,1984298
4733,Portugal,PRT,2013,801609,1161879,1963488
4734,Portugal,PRT,2014,800082,1145901,1945983
4735,Portugal,PRT,2015,798579,1138985,1937564
4736,Portugal,PRT,2016,796133,1151664,1947797
4737,Portugal,PRT,2017,794110,1165330,1959440
4738,Portugal,PRT,2018,793731,1166882,1960613
4739,Portugal,PRT,2019,794136,1166089,1960225
4740,Puerto Rico,PRI,1990,243125,249898,493023
4741,Puerto Rico,PRI,1991,245423,253344,498767
4742,Puerto Rico,PRI,1992,247762,256709,504471
4743,Puerto Rico,PRI,1993,249966,260033,509999
4744,Puerto Rico,PRI,1994,251923,263131,515054
4745,Puerto Rico,PRI,1995,253689,265810,519499
4746,Puerto Rico,PRI,1996,254997,268248,523245
4747,Puerto Rico,PRI,1997,255922,270531,526453
4748,Puerto Rico,PRI,1998,256741,272581,529322
4749,Puerto Rico,PRI,1999,257321,274383,531704
4750,Puerto Rico,PRI,2000,257949,275850,533799
4751,Puerto Rico,PRI,2001,258353,277004,535357
4752,Puerto Rico,PRI,2002,258558,277789,536347
4753,Puerto Rico,PRI,2003,258604,278207,536811
4754,Puerto Rico,PRI,2004,258396,278462,536858
4755,Puerto Rico,PRI,2005,257951,278474,536425
4756,Puerto Rico,PRI,2006,256987,277951,534938
4757,Puerto Rico,PRI,2007,255487,276732,532219
4758,Puerto Rico,PRI,2008,253777,275434,529211
4759,Puerto Rico,PRI,2009,252159,274322,526481
4760,Puerto Rico,PRI,2010,250954,273664,524618
4761,Puerto Rico,PRI,2011,250120,273556,523676
4762,Puerto Rico,PRI,2012,249594,273831,523425
4763,Puerto Rico,PRI,2013,249181,274188,523369
4764,Puerto Rico,PRI,2014,248666,274419,523085
4765,Puerto Rico,PRI,2015,247725,274280,522005
4766,Puerto Rico,PRI,2016,246146,273731,519877
4767,Puerto Rico,PRI,2017,240521,270177,510698
4768,Puerto Rico,PRI,2018,235300,267046,502346
4769,Puerto Rico,PRI,2019,233898,267090,500988
4770,Qatar,QAT,1990,39561,19875,59436
4771,Qatar,QAT,1991,40803,20729,61532
4772,Qatar,QAT,1992,41995,21585,63580
4773,Qatar,QAT,1993,43123,22433,65556
4774,Qatar,QAT,1994,44214,23269,67483
4775,Qatar,QAT,1995,45290,24136,69426
4776,Qatar,QAT,1996,46357,25012,71369
4777,Qatar,QAT,1997,47448,25891,73339
4778,Qatar,QAT,1998,48562,26820,75382
4779,Qatar,QAT,1999,49904,27841,77745
4780,Qatar,QAT,2000,51745,29034,80779
4781,Qatar,QAT,2001,54251,30453,84704
4782,Qatar,QAT,2002,57741,32150,89891
4783,Qatar,QAT,2003,62666,34179,96845
4784,Qatar,QAT,2004,69573,36665,106238
4785,Qatar,QAT,2005,79678,39739,119417
4786,Qatar,QAT,2006,93387,43380,136767
4787,Qatar,QAT,2007,111137,47566,158703
4788,Qatar,QAT,2008,132997,52271,185268
4789,Qatar,QAT,2009,158321,57446,215767
4790,Qatar,QAT,2010,184593,62944,247537
4791,Qatar,QAT,2011,207413,68467,275880
4792,Qatar,QAT,2012,225827,73922,299749
4793,Qatar,QAT,2013,239622,79235,318857
4794,Qatar,QAT,2014,250355,84416,334771
4795,Qatar,QAT,2015,259635,89468,349103
4796,Qatar,QAT,2016,269418,94406,363824
4797,Qatar,QAT,2017,279258,99396,378654
4798,Qatar,QAT,2018,289298,104793,394091
4799,Qatar,QAT,2019,299458,110678,410136
4800,Region of the Americas (WHO),,1990,45128414,52056172,97184586
4801,Region of the Americas (WHO),,1991,45964708,53211019,99175727
4802,Region of the Americas (WHO),,1992,46824340,54388179,101212519
4803,Region of the Americas (WHO),,1993,47695546,55564785,103260331
4804,Region of the Americas (WHO),,1994,48575350,56728668,105304018
4805,Region of the Americas (WHO),,1995,49448884,57865946,107314830
4806,Region of the Americas (WHO),,1996,50494797,59330706,109825503
4807,Region of the Americas (WHO),,1997,51789663,61292568,113082231
4808,Region of the Americas (WHO),,1998,53174751,63468570,116643321
4809,Region of the Americas (WHO),,1999,54492113,65560869,120052982
4810,Region of the Americas (WHO),,2000,55550004,67259147,122809151
4811,Region of the Americas (WHO),,2001,56384318,68615415,124999733
4812,Region of the Americas (WHO),,2002,57146967,69881872,127028839
4813,Region of the Americas (WHO),,2003,57857411,71057344,128914755
4814,Region of the Americas (WHO),,2004,58552123,72140588,130692711
4815,Region of the Americas (WHO),,2005,59243731,73107750,132351481
4816,Region of the Americas (WHO),,2006,59921195,73924899,133846094
4817,Region of the Americas (WHO),,2007,60550325,74594052,135144377
4818,Region of the Americas (WHO),,2008,61151938,75188253,136340191
4819,Region of the Americas (WHO),,2009,61736044,75788534,137524578
4820,Region of the Americas (WHO),,2010,62304687,76464909,138769596
4821,Region of the Americas (WHO),,2011,62793808,76971325,139765133
4822,Region of the Americas (WHO),,2012,63166135,77118986,140285121
4823,Region of the Americas (WHO),,2013,63499762,77142866,140642628
4824,Region of the Americas (WHO),,2014,63870871,77271193,141142064
4825,Region of the Americas (WHO),,2015,64349705,77750454,142100159
4826,Region of the Americas (WHO),,2016,65053011,78566212,143619223
4827,Region of the Americas (WHO),,2017,65747943,79403230,145151173
4828,Region of the Americas (WHO),,2018,66473830,80541188,147015018
4829,Region of the Americas (WHO),,2019,67405318,82093938,149499256
4830,Romania,ROU,1990,1185737,1409151,2594888
4831,Romania,ROU,1991,1190295,1414324,2604619
4832,Romania,ROU,1992,1192772,1417022,2609794
4833,Romania,ROU,1993,1192949,1419121,2612070
4834,Romania,ROU,1994,1192552,1421151,2613703
4835,Romania,ROU,1995,1190274,1422288,2612562
4836,Romania,ROU,1996,1185299,1421999,2607298
4837,Romania,ROU,1997,1178589,1419403,2597992
4838,Romania,ROU,1998,1171098,1416373,2587471
4839,Romania,ROU,1999,1164053,1412999,2577052
4840,Romania,ROU,2000,1157558,1409424,2566982
4841,Romania,ROU,2001,1149783,1404313,2554096
4842,Romania,ROU,2002,1139971,1397535,2537506
4843,Romania,ROU,2003,1128786,1387303,2516089
4844,Romania,ROU,2004,1117811,1377523,2495334
4845,Romania,ROU,2005,1106174,1366761,2472935
4846,Romania,ROU,2006,1093442,1354112,2447554
4847,Romania,ROU,2007,1079780,1340449,2420229
4848,Romania,ROU,2008,1066220,1326912,2393132
4849,Romania,ROU,2009,1053803,1314404,2368207
4850,Romania,ROU,2010,1041790,1302726,2344516
4851,Romania,ROU,2011,1032222,1293534,2325756
4852,Romania,ROU,2012,1025072,1285524,2310596
4853,Romania,ROU,2013,1019694,1278942,2298636
4854,Romania,ROU,2014,1012519,1271508,2284027
4855,Romania,ROU,2015,1002852,1261302,2264154
4856,Romania,ROU,2016,993000,1249864,2242864
4857,Romania,ROU,2017,985321,1240192,2225513
4858,Romania,ROU,2018,977491,1233260,2210751
4859,Romania,ROU,2019,969061,1228374,2197435
4860,Russia,RUS,1990,7594320,9324430,16918750
4861,Russia,RUS,1991,7678870,9399567,17078437
4862,Russia,RUS,1992,7761009,9472800,17233809
4863,Russia,RUS,1993,7826337,9533297,17359634
4864,Russia,RUS,1994,7868544,9575762,17444306
4865,Russia,RUS,1995,7902399,9614152,17516551
4866,Russia,RUS,1996,7946578,9653248,17599826
4867,Russia,RUS,1997,7999996,9687790,17687786
4868,Russia,RUS,1998,8048493,9712944,17761437
4869,Russia,RUS,1999,8076403,9722212,17798615
4870,Russia,RUS,2000,8075478,9720190,17795668
4871,Russia,RUS,2001,8046177,9702019,17748196
4872,Russia,RUS,2002,7994973,9667335,17662308
4873,Russia,RUS,2003,7925419,9617109,17542528
4874,Russia,RUS,2004,7849206,9562778,17411984
4875,Russia,RUS,2005,7770343,9511726,17282069
4876,Russia,RUS,2006,7684649,9458413,17143062
4877,Russia,RUS,2007,7595178,9403305,16998483
4878,Russia,RUS,2008,7508496,9347075,16855571
4879,Russia,RUS,2009,7432631,9295013,16727644
4880,Russia,RUS,2010,7378989,9255105,16634094
4881,Russia,RUS,2011,7347721,9239584,16587305
4882,Russia,RUS,2012,7331030,9247370,16578400
4883,Russia,RUS,2013,7325188,9265513,16590701
4884,Russia,RUS,2014,7322118,9277646,16599764
4885,Russia,RUS,2015,7318354,9271882,16590236
4886,Russia,RUS,2016,7323806,9248315,16572121
4887,Russia,RUS,2017,7336589,9227916,16564505
4888,Russia,RUS,2018,7345790,9214845,16560635
4889,Russia,RUS,2019,7346966,9195539,16542505
4890,Rwanda,RWA,1990,369413,427720,797133
4891,Rwanda,RWA,1991,384153,443809,827962
4892,Rwanda,RWA,1992,354957,408802,763759
4893,Rwanda,RWA,1993,293659,337269,630928
4894,Rwanda,RWA,1994,278919,331300,610219
4895,Rwanda,RWA,1995,308756,377391,686147
4896,Rwanda,RWA,1996,360878,438753,799631
4897,Rwanda,RWA,1997,395299,479310,874609
4898,Rwanda,RWA,1998,405398,491192,896590
4899,Rwanda,RWA,1999,413595,501067,914662
4900,Rwanda,RWA,2000,423807,513570,937377
4901,Rwanda,RWA,2001,434064,527150,961214
4902,Rwanda,RWA,2002,443700,539757,983457
4903,Rwanda,RWA,2003,452724,552009,1004733
4904,Rwanda,RWA,2004,461735,563150,1024885
4905,Rwanda,RWA,2005,472149,575337,1047486
4906,Rwanda,RWA,2006,483736,587524,1071260
4907,Rwanda,RWA,2007,493761,596226,1089987
4908,Rwanda,RWA,2008,503397,603121,1106518
4909,Rwanda,RWA,2009,514792,612524,1127316
4910,Rwanda,RWA,2010,528787,626649,1155436
4911,Rwanda,RWA,2011,543531,643271,1186802
4912,Rwanda,RWA,2012,559472,660105,1219577
4913,Rwanda,RWA,2013,574237,675390,1249627
4914,Rwanda,RWA,2014,586481,688824,1275305
4915,Rwanda,RWA,2015,601602,705949,1307551
4916,Rwanda,RWA,2016,619301,727070,1346371
4917,Rwanda,RWA,2017,636651,747521,1384172
4918,Rwanda,RWA,2018,653501,766662,1420163
4919,Rwanda,RWA,2019,671960,785769,1457729
4920,Saint Kitts and Nevis,KNA,1990,2834,2944,5778
4921,Saint Kitts and Nevis,KNA,1991,2841,2950,5791
4922,Saint Kitts and Nevis,KNA,1992,2860,2970,5830
4923,Saint Kitts and Nevis,KNA,1993,2888,2999,5887
4924,Saint Kitts and Nevis,KNA,1994,2926,3036,5962
4925,Saint Kitts and Nevis,KNA,1995,2972,3080,6052
4926,Saint Kitts and Nevis,KNA,1996,3025,3131,6156
4927,Saint Kitts and Nevis,KNA,1997,3084,3190,6274
4928,Saint Kitts and Nevis,KNA,1998,3147,3255,6402
4929,Saint Kitts and Nevis,KNA,1999,3214,3324,6538
4930,Saint Kitts and Nevis,KNA,2000,3282,3395,6677
4931,Saint Kitts and Nevis,KNA,2001,3352,3465,6817
4932,Saint Kitts and Nevis,KNA,2002,3423,3536,6959
4933,Saint Kitts and Nevis,KNA,2003,3491,3605,7096
4934,Saint Kitts and Nevis,KNA,2004,3560,3676,7236
4935,Saint Kitts and Nevis,KNA,2005,3626,3747,7373
4936,Saint Kitts and Nevis,KNA,2006,3690,3818,7508
4937,Saint Kitts and Nevis,KNA,2007,3751,3888,7639
4938,Saint Kitts and Nevis,KNA,2008,3811,3960,7771
4939,Saint Kitts and Nevis,KNA,2009,3871,4031,7902
4940,Saint Kitts and Nevis,KNA,2010,3928,4102,8030
4941,Saint Kitts and Nevis,KNA,2011,3986,4173,8159
4942,Saint Kitts and Nevis,KNA,2012,4046,4242,8288
4943,Saint Kitts and Nevis,KNA,2013,4104,4313,8417
4944,Saint Kitts and Nevis,KNA,2014,4157,4380,8537
4945,Saint Kitts and Nevis,KNA,2015,4206,4444,8650
4946,Saint Kitts and Nevis,KNA,2016,4246,4503,8749
4947,Saint Kitts and Nevis,KNA,2017,4284,4559,8843
4948,Saint Kitts and Nevis,KNA,2018,4324,4616,8940
4949,Saint Kitts and Nevis,KNA,2019,4365,4671,9036
4950,Saint Lucia,LCA,1990,9120,9040,18160
4951,Saint Lucia,LCA,1991,9258,9173,18431
4952,Saint Lucia,LCA,1992,9400,9311,18711
4953,Saint Lucia,LCA,1993,9549,9455,19004
4954,Saint Lucia,LCA,1994,9701,9605,19306
4955,Saint Lucia,LCA,1995,9864,9764,19628
4956,Saint Lucia,LCA,1996,10026,9936,19962
4957,Saint Lucia,LCA,1997,10194,10107,20301
4958,Saint Lucia,LCA,1998,10365,10285,20650
4959,Saint Lucia,LCA,1999,10536,10460,20996
4960,Saint Lucia,LCA,2000,10704,10632,21336
4961,Saint Lucia,LCA,2001,10867,10800,21667
4962,Saint Lucia,LCA,2002,11027,10958,21985
4963,Saint Lucia,LCA,2003,11183,11108,22291
4964,Saint Lucia,LCA,2004,11329,11255,22584
4965,Saint Lucia,LCA,2005,11469,11401,22870
4966,Saint Lucia,LCA,2006,11596,11543,23139
4967,Saint Lucia,LCA,2007,11711,11683,23394
4968,Saint Lucia,LCA,2008,11819,11813,23632
4969,Saint Lucia,LCA,2009,11924,11950,23874
4970,Saint Lucia,LCA,2010,12022,12080,24102
4971,Saint Lucia,LCA,2011,12116,12215,24331
4972,Saint Lucia,LCA,2012,12210,12348,24558
4973,Saint Lucia,LCA,2013,12294,12480,24774
4974,Saint Lucia,LCA,2014,12373,12598,24971
4975,Saint Lucia,LCA,2015,12433,12709,25142
4976,Saint Lucia,LCA,2016,12466,12806,25272
4977,Saint Lucia,LCA,2017,12487,12892,25379
4978,Saint Lucia,LCA,2018,12526,12986,25512
4979,Saint Lucia,LCA,2019,12567,13099,25666
4980,Saint Vincent and the Grenadines,VCT,1990,7653,7150,14803
4981,Saint Vincent and the Grenadines,VCT,1991,7690,7157,14847
4982,Saint Vincent and the Grenadines,VCT,1992,7722,7161,14883
4983,Saint Vincent and the Grenadines,VCT,1993,7746,7164,14910
4984,Saint Vincent and the Grenadines,VCT,1994,7764,7169,14933
4985,Saint Vincent and the Grenadines,VCT,1995,7777,7179,14956
4986,Saint Vincent and the Grenadines,VCT,1996,7782,7195,14977
4987,Saint Vincent and the Grenadines,VCT,1997,7788,7214,15002
4988,Saint Vincent and the Grenadines,VCT,1998,7794,7233,15027
4989,Saint Vincent and the Grenadines,VCT,1999,7804,7254,15058
4990,Saint Vincent and the Grenadines,VCT,2000,7811,7271,15082
4991,Saint Vincent and the Grenadines,VCT,2001,7829,7292,15121
4992,Saint Vincent and the Grenadines,VCT,2002,7854,7310,15164
4993,Saint Vincent and the Grenadines,VCT,2003,7883,7334,15217
4994,Saint Vincent and the Grenadines,VCT,2004,7918,7363,15281
4995,Saint Vincent and the Grenadines,VCT,2005,7949,7390,15339
4996,Saint Vincent and the Grenadines,VCT,2006,7982,7423,15405
4997,Saint Vincent and the Grenadines,VCT,2007,8015,7456,15471
4998,Saint Vincent and the Grenadines,VCT,2008,8049,7491,15540
4999,Saint Vincent and the Grenadines,VCT,2009,8085,7525,15610
5000,Saint Vincent and the Grenadines,VCT,2010,8118,7563,15681
5001,Saint Vincent and the Grenadines,VCT,2011,8157,7607,15764
5002,Saint Vincent and the Grenadines,VCT,2012,8194,7656,15850
5003,Saint Vincent and the Grenadines,VCT,2013,8229,7709,15938
5004,Saint Vincent and the Grenadines,VCT,2014,8260,7757,16017
5005,Saint Vincent and the Grenadines,VCT,2015,8280,7796,16076
5006,Saint Vincent and the Grenadines,VCT,2016,8281,7830,16111
5007,Saint Vincent and the Grenadines,VCT,2017,8283,7862,16145
5008,Saint Vincent and the Grenadines,VCT,2018,8297,7908,16205
5009,Saint Vincent and the Grenadines,VCT,2019,8330,7973,16303
5010,Samoa,WSM,1990,9197,8327,17524
5011,Samoa,WSM,1991,9233,8389,17622
5012,Samoa,WSM,1992,9273,8462,17735
5013,Samoa,WSM,1993,9315,8535,17850
5014,Samoa,WSM,1994,9358,8608,17966
5015,Samoa,WSM,1995,9406,8684,18090
5016,Samoa,WSM,1996,9455,8759,18214
5017,Samoa,WSM,1997,9508,8832,18340
5018,Samoa,WSM,1998,9557,8905,18462
5019,Samoa,WSM,1999,9610,8980,18590
5020,Samoa,WSM,2000,9662,9056,18718
5021,Samoa,WSM,2001,9713,9126,18839
5022,Samoa,WSM,2002,9759,9193,18952
5023,Samoa,WSM,2003,9796,9257,19053
5024,Samoa,WSM,2004,9836,9318,19154
5025,Samoa,WSM,2005,9877,9384,19261
5026,Samoa,WSM,2006,9918,9450,19368
5027,Samoa,WSM,2007,9960,9515,19475
5028,Samoa,WSM,2008,10012,9584,19596
5029,Samoa,WSM,2009,10075,9665,19740
5030,Samoa,WSM,2010,10160,9757,19917
5031,Samoa,WSM,2011,10277,9874,20151
5032,Samoa,WSM,2012,10420,10021,20441
5033,Samoa,WSM,2013,10584,10188,20772
5034,Samoa,WSM,2014,10760,10371,21131
5035,Samoa,WSM,2015,10941,10563,21504
5036,Samoa,WSM,2016,11107,10742,21849
5037,Samoa,WSM,2017,11266,10926,22192
5038,Samoa,WSM,2018,11458,11140,22598
5039,Samoa,WSM,2019,11658,11376,23034
5040,San Marino,SMR,1990,1606,1976,3582
5041,San Marino,SMR,1991,1626,2011,3637
5042,San Marino,SMR,1992,1647,2045,3692
5043,San Marino,SMR,1993,1668,2081,3749
5044,San Marino,SMR,1994,1688,2117,3805
5045,San Marino,SMR,1995,1709,2153,3862
5046,San Marino,SMR,1996,1731,2190,3921
5047,San Marino,SMR,1997,1752,2227,3979
5048,San Marino,SMR,1998,1774,2264,4038
5049,San Marino,SMR,1999,1796,2302,4098
5050,San Marino,SMR,2000,1819,2339,4158
5051,San Marino,SMR,2001,1841,2377,4218
5052,San Marino,SMR,2002,1865,2414,4279
5053,San Marino,SMR,2003,1887,2450,4337
5054,San Marino,SMR,2004,1911,2485,4396
5055,San Marino,SMR,2005,1934,2520,4454
5056,San Marino,SMR,2006,1957,2553,4510
5057,San Marino,SMR,2007,1979,2585,4564
5058,San Marino,SMR,2008,2001,2616,4617
5059,San Marino,SMR,2009,2023,2647,4670
5060,San Marino,SMR,2010,2044,2677,4721
5061,San Marino,SMR,2011,2064,2708,4772
5062,San Marino,SMR,2012,2083,2740,4823
5063,San Marino,SMR,2013,2101,2769,4870
5064,San Marino,SMR,2014,2119,2797,4916
5065,San Marino,SMR,2015,2135,2823,4958
5066,San Marino,SMR,2016,2150,2846,4996
5067,San Marino,SMR,2017,2164,2866,5030
5068,San Marino,SMR,2018,2177,2886,5063
5069,San Marino,SMR,2019,2190,2906,5096
5070,Sao Tome and Principe,STP,1990,5450,5755,11205
5071,Sao Tome and Principe,STP,1991,5568,5875,11443
5072,Sao Tome and Principe,STP,1992,5680,5991,11671
5073,Sao Tome and Principe,STP,1993,5789,6102,11891
5074,Sao Tome and Principe,STP,1994,5897,6213,12110
5075,Sao Tome and Principe,STP,1995,6002,6326,12328
5076,Sao Tome and Principe,STP,1996,6103,6435,12538
5077,Sao Tome and Principe,STP,1997,6205,6550,12755
5078,Sao Tome and Principe,STP,1998,6307,6667,12974
5079,Sao Tome and Principe,STP,1999,6412,6786,13198
5080,Sao Tome and Principe,STP,2000,6525,6912,13437
5081,Sao Tome and Principe,STP,2001,6644,7041,13685
5082,Sao Tome and Principe,STP,2002,6769,7178,13947
5083,Sao Tome and Principe,STP,2003,6903,7322,14225
5084,Sao Tome and Principe,STP,2004,7051,7472,14523
5085,Sao Tome and Principe,STP,2005,7205,7629,14834
5086,Sao Tome and Principe,STP,2006,7366,7791,15157
5087,Sao Tome and Principe,STP,2007,7536,7957,15493
5088,Sao Tome and Principe,STP,2008,7709,8125,15834
5089,Sao Tome and Principe,STP,2009,7890,8306,16196
5090,Sao Tome and Principe,STP,2010,8092,8498,16590
5091,Sao Tome and Principe,STP,2011,8300,8703,17003
5092,Sao Tome and Principe,STP,2012,8514,8919,17433
5093,Sao Tome and Principe,STP,2013,8742,9142,17884
5094,Sao Tome and Principe,STP,2014,8968,9372,18340
5095,Sao Tome and Principe,STP,2015,9194,9606,18800
5096,Sao Tome and Principe,STP,2016,9419,9838,19257
5097,Sao Tome and Principe,STP,2017,9645,10077,19722
5098,Sao Tome and Principe,STP,2018,9883,10334,20217
5099,Sao Tome and Principe,STP,2019,10124,10608,20732
5100,Saudi Arabia,SAU,1990,1053892,849047,1902939
5101,Saudi Arabia,SAU,1991,1099332,885303,1984635
5102,Saudi Arabia,SAU,1992,1142185,920985,2063170
5103,Saudi Arabia,SAU,1993,1182176,955696,2137872
5104,Saudi Arabia,SAU,1994,1218763,990059,2208822
5105,Saudi Arabia,SAU,1995,1253096,1023883,2276979
5106,Saudi Arabia,SAU,1996,1286102,1057353,2343455
5107,Saudi Arabia,SAU,1997,1318826,1090900,2409726
5108,Saudi Arabia,SAU,1998,1351281,1124846,2476127
5109,Saudi Arabia,SAU,1999,1384256,1159427,2543683
5110,Saudi Arabia,SAU,2000,1417860,1195672,2613532
5111,Saudi Arabia,SAU,2001,1453206,1233317,2686523
5112,Saudi Arabia,SAU,2002,1493284,1272594,2765878
5113,Saudi Arabia,SAU,2003,1538022,1314227,2852249
5114,Saudi Arabia,SAU,2004,1590353,1361304,2951657
5115,Saudi Arabia,SAU,2005,1651039,1412764,3063803
5116,Saudi Arabia,SAU,2006,1720590,1469907,3190497
5117,Saudi Arabia,SAU,2007,1797518,1531145,3328663
5118,Saudi Arabia,SAU,2008,1881061,1595188,3476249
5119,Saudi Arabia,SAU,2009,1968186,1660573,3628759
5120,Saudi Arabia,SAU,2010,2057626,1726851,3784477
5121,Saudi Arabia,SAU,2011,2146105,1792454,3938559
5122,Saudi Arabia,SAU,2012,2234902,1859220,4094122
5123,Saudi Arabia,SAU,2013,2321769,1925897,4247666
5124,Saudi Arabia,SAU,2014,2408623,1990295,4398918
5125,Saudi Arabia,SAU,2015,2492123,2052163,4544286
5126,Saudi Arabia,SAU,2016,2570234,2108824,4679058
5127,Saudi Arabia,SAU,2017,2644163,2162953,4807116
5128,Saudi Arabia,SAU,2018,2720097,2224650,4944747
5129,Saudi Arabia,SAU,2019,2796083,2291869,5087952
5130,Scotland,,1990,320345,387045,707390
5131,Scotland,,1991,318968,384626,703594
5132,Scotland,,1992,317734,382211,699945
5133,Scotland,,1993,316731,380217,696948
5134,Scotland,,1994,316300,378872,695172
5135,Scotland,,1995,316552,378508,695060
5136,Scotland,,1996,317280,378824,696104
5137,Scotland,,1997,318420,379056,697476
5138,Scotland,,1998,319524,379327,698851
5139,Scotland,,1999,320595,379496,700091
5140,Scotland,,2000,321603,379707,701310
5141,Scotland,,2001,322276,379282,701558
5142,Scotland,,2002,322319,377846,700165
5143,Scotland,,2003,322278,376123,698401
5144,Scotland,,2004,322330,375021,697351
5145,Scotland,,2005,323097,375404,698501
5146,Scotland,,2006,324512,377538,702050
5147,Scotland,,2007,325966,380797,706763
5148,Scotland,,2008,327550,384614,712164
5149,Scotland,,2009,329211,388377,717588
5150,Scotland,,2010,330979,391384,722363
5151,Scotland,,2011,332887,394279,727166
5152,Scotland,,2012,335244,397245,732489
5153,Scotland,,2013,337506,400086,737592
5154,Scotland,,2014,339639,402460,742099
5155,Scotland,,2015,341282,404169,745451
5156,Scotland,,2016,342535,404450,746985
5157,Scotland,,2017,343716,404410,748126
5158,Scotland,,2018,344751,405192,749943
5159,Scotland,,2019,345624,406365,751989
5160,Senegal,SEN,1990,334233,352054,686287
5161,Senegal,SEN,1991,345149,362928,708077
5162,Senegal,SEN,1992,356466,374319,730785
5163,Senegal,SEN,1993,368224,385850,754074
5164,Senegal,SEN,1994,380069,397809,777878
5165,Senegal,SEN,1995,392126,409923,802049
5166,Senegal,SEN,1996,404416,422035,826451
5167,Senegal,SEN,1997,416649,433769,850418
5168,Senegal,SEN,1998,428858,445514,874372
5169,Senegal,SEN,1999,441349,457144,898493
5170,Senegal,SEN,2000,453979,469380,923359
5171,Senegal,SEN,2001,466742,481631,948373
5172,Senegal,SEN,2002,479202,493766,972968
5173,Senegal,SEN,2003,491637,506106,997743
5174,Senegal,SEN,2004,504318,517882,1022200
5175,Senegal,SEN,2005,516897,529770,1046667
5176,Senegal,SEN,2006,529335,541652,1070987
5177,Senegal,SEN,2007,541813,553434,1095247
5178,Senegal,SEN,2008,554119,565218,1119337
5179,Senegal,SEN,2009,567364,577572,1144936
5180,Senegal,SEN,2010,581184,590547,1171731
5181,Senegal,SEN,2011,595966,605044,1201010
5182,Senegal,SEN,2012,611431,620677,1232108
5183,Senegal,SEN,2013,627593,637018,1264611
5184,Senegal,SEN,2014,644465,654319,1298784
5185,Senegal,SEN,2015,661257,670534,1331791
5186,Senegal,SEN,2016,678363,685866,1364229
5187,Senegal,SEN,2017,695010,700942,1395952
5188,Senegal,SEN,2018,712361,718266,1430627
5189,Senegal,SEN,2019,730974,737290,1468264
5190,Serbia,SRB,1990,482971,595903,1078874
5191,Serbia,SRB,1991,496884,608752,1105636
5192,Serbia,SRB,1992,505083,617269,1122352
5193,Serbia,SRB,1993,508397,621894,1130291
5194,Serbia,SRB,1994,513431,627433,1140864
5195,Serbia,SRB,1995,514384,629779,1144163
5196,Serbia,SRB,1996,514006,630776,1144782
5197,Serbia,SRB,1997,500488,621550,1122038
5198,Serbia,SRB,1998,484160,609423,1093583
5199,Serbia,SRB,1999,492523,617105,1109628
5200,Serbia,SRB,2000,502389,625550,1127939
5201,Serbia,SRB,2001,496529,620837,1117366
5202,Serbia,SRB,2002,491834,616724,1108558
5203,Serbia,SRB,2003,489787,614887,1104674
5204,Serbia,SRB,2004,485292,610700,1095992
5205,Serbia,SRB,2005,480593,606571,1087164
5206,Serbia,SRB,2006,477144,603325,1080469
5207,Serbia,SRB,2007,473274,599508,1072782
5208,Serbia,SRB,2008,468636,594660,1063296
5209,Serbia,SRB,2009,464724,590197,1054921
5210,Serbia,SRB,2010,462181,586849,1049030
5211,Serbia,SRB,2011,461374,585095,1046469
5212,Serbia,SRB,2012,461440,583761,1045201
5213,Serbia,SRB,2013,459571,581262,1040833
5214,Serbia,SRB,2014,457490,578242,1035732
5215,Serbia,SRB,2015,456588,576310,1032898
5216,Serbia,SRB,2016,455896,574490,1030386
5217,Serbia,SRB,2017,454975,572408,1027383
5218,Serbia,SRB,2018,453172,569631,1022803
5219,Serbia,SRB,2019,450953,566467,1017420
5220,Seychelles,SYC,1990,3615,3868,7483
5221,Seychelles,SYC,1991,3657,3914,7571
5222,Seychelles,SYC,1992,3701,3966,7667
5223,Seychelles,SYC,1993,3744,4018,7762
5224,Seychelles,SYC,1994,3785,4077,7862
5225,Seychelles,SYC,1995,3824,4137,7961
5226,Seychelles,SYC,1996,3864,4202,8066
5227,Seychelles,SYC,1997,3909,4266,8175
5228,Seychelles,SYC,1998,3963,4332,8295
5229,Seychelles,SYC,1999,4029,4401,8430
5230,Seychelles,SYC,2000,4104,4470,8574
5231,Seychelles,SYC,2001,4187,4539,8726
5232,Seychelles,SYC,2002,4270,4610,8880
5233,Seychelles,SYC,2003,4352,4677,9029
5234,Seychelles,SYC,2004,4432,4740,9172
5235,Seychelles,SYC,2005,4516,4799,9315
5236,Seychelles,SYC,2006,4600,4854,9454
5237,Seychelles,SYC,2007,4684,4905,9589
5238,Seychelles,SYC,2008,4769,4953,9722
5239,Seychelles,SYC,2009,4853,5004,9857
5240,Seychelles,SYC,2010,4938,5054,9992
5241,Seychelles,SYC,2011,5020,5109,10129
5242,Seychelles,SYC,2012,5099,5166,10265
5243,Seychelles,SYC,2013,5179,5222,10401
5244,Seychelles,SYC,2014,5257,5278,10535
5245,Seychelles,SYC,2015,5328,5332,10660
5246,Seychelles,SYC,2016,5391,5387,10778
5247,Seychelles,SYC,2017,5453,5442,10895
5248,Seychelles,SYC,2018,5518,5500,11018
5249,Seychelles,SYC,2019,5587,5565,11152
5250,Sierra Leone,SLE,1990,178946,198928,377874
5251,Sierra Leone,SLE,1991,173328,195681,369009
5252,Sierra Leone,SLE,1992,173419,197302,370721
5253,Sierra Leone,SLE,1993,176643,201643,378286
5254,Sierra Leone,SLE,1994,178730,204998,383728
5255,Sierra Leone,SLE,1995,182630,210011,392641
5256,Sierra Leone,SLE,1996,185456,214367,399823
5257,Sierra Leone,SLE,1997,186236,216708,402944
5258,Sierra Leone,SLE,1998,192202,223992,416194
5259,Sierra Leone,SLE,1999,203527,236190,439717
5260,Sierra Leone,SLE,2000,216891,249999,466890
5261,Sierra Leone,SLE,2001,230967,264176,495143
5262,Sierra Leone,SLE,2002,244360,277589,521949
5263,Sierra Leone,SLE,2003,256225,289681,545906
5264,Sierra Leone,SLE,2004,266359,300134,566493
5265,Sierra Leone,SLE,2005,275412,309452,584864
5266,Sierra Leone,SLE,2006,283813,318361,602174
5267,Sierra Leone,SLE,2007,292671,327681,620352
5268,Sierra Leone,SLE,2008,302541,338246,640787
5269,Sierra Leone,SLE,2009,313195,349139,662334
5270,Sierra Leone,SLE,2010,323951,360327,684278
5271,Sierra Leone,SLE,2011,334877,371175,706052
5272,Sierra Leone,SLE,2012,345547,382049,727596
5273,Sierra Leone,SLE,2013,356894,393352,750246
5274,Sierra Leone,SLE,2014,368340,404936,773276
5275,Sierra Leone,SLE,2015,380413,417050,797463
5276,Sierra Leone,SLE,2016,393197,430568,823765
5277,Sierra Leone,SLE,2017,406239,444441,850680
5278,Sierra Leone,SLE,2018,419843,458359,878202
5279,Sierra Leone,SLE,2019,433711,472024,905735
5280,Singapore,SGP,1990,176029,173602,349631
5281,Singapore,SGP,1991,181235,178038,359273
5282,Singapore,SGP,1992,186089,183279,369368
5283,Singapore,SGP,1993,190272,187508,377780
5284,Singapore,SGP,1994,196098,192571,388669
5285,Singapore,SGP,1995,201922,197742,399664
5286,Singapore,SGP,1996,212023,203347,415370
5287,Singapore,SGP,1997,220243,208925,429168
5288,Singapore,SGP,1998,229527,214780,444307
5289,Singapore,SGP,1999,229150,218578,447728
5290,Singapore,SGP,2000,232027,222622,454649
5291,Singapore,SGP,2001,237288,227113,464401
5292,Singapore,SGP,2002,236802,226800,463602
5293,Singapore,SGP,2003,230057,221571,451628
5294,Singapore,SGP,2004,231469,221631,453100
5295,Singapore,SGP,2005,236868,225181,462049
5296,Singapore,SGP,2006,245673,230552,476225
5297,Singapore,SGP,2007,258801,237107,495908
5298,Singapore,SGP,2008,276334,245802,522136
5299,Singapore,SGP,2009,284437,253024,537461
5300,Singapore,SGP,2010,288027,258543,546570
5301,Singapore,SGP,2011,292194,264199,556393
5302,Singapore,SGP,2012,298764,268858,567622
5303,Singapore,SGP,2013,303343,270332,573675
5304,Singapore,SGP,2014,305689,272157,577846
5305,Singapore,SGP,2015,306827,275041,581868
5306,Singapore,SGP,2016,308758,278928,587686
5307,Singapore,SGP,2017,304883,281387,586270
5308,Singapore,SGP,2018,303218,284212,587430
5309,Singapore,SGP,2019,302621,287071,589692
5310,Slovakia,SVK,1990,263241,329790,593031
5311,Slovakia,SVK,1991,265017,332642,597659
5312,Slovakia,SVK,1992,266653,335194,601847
5313,Slovakia,SVK,1993,268167,337961,606128
5314,Slovakia,SVK,1994,269572,340506,610078
5315,Slovakia,SVK,1995,270920,342957,613877
5316,Slovakia,SVK,1996,271974,345438,617412
5317,Slovakia,SVK,1997,272734,347746,620480
5318,Slovakia,SVK,1998,273220,350086,623306
5319,Slovakia,SVK,1999,273287,351961,625248
5320,Slovakia,SVK,2000,273527,353577,627104
5321,Slovakia,SVK,2001,273970,354904,628874
5322,Slovakia,SVK,2002,274284,355919,630203
5323,Slovakia,SVK,2003,274394,356829,631223
5324,Slovakia,SVK,2004,274309,357425,631734
5325,Slovakia,SVK,2005,274052,357849,631901
5326,Slovakia,SVK,2006,273465,357957,631422
5327,Slovakia,SVK,2007,272677,357927,630604
5328,Slovakia,SVK,2008,271761,357816,629577
5329,Slovakia,SVK,2009,271089,357667,628756
5330,Slovakia,SVK,2010,270570,357339,627909
5331,Slovakia,SVK,2011,270176,357141,627317
5332,Slovakia,SVK,2012,269800,356441,626241
5333,Slovakia,SVK,2013,269591,355653,625244
5334,Slovakia,SVK,2014,269491,355146,624637
5335,Slovakia,SVK,2015,269450,354847,624297
5336,Slovakia,SVK,2016,269592,354247,623839
5337,Slovakia,SVK,2017,269704,353700,623404
5338,Slovakia,SVK,2018,269465,354128,623593
5339,Slovakia,SVK,2019,269091,355365,624456
5340,Slovenia,SVN,1990,103867,138411,242278
5341,Slovenia,SVN,1991,104654,139381,244035
5342,Slovenia,SVN,1992,105354,140260,245614
5343,Slovenia,SVN,1993,105942,141017,246959
5344,Slovenia,SVN,1994,106452,141657,248109
5345,Slovenia,SVN,1995,106865,142272,249137
5346,Slovenia,SVN,1996,107164,142674,249838
5347,Slovenia,SVN,1997,107285,142812,250097
5348,Slovenia,SVN,1998,107300,142764,250064
5349,Slovenia,SVN,1999,107245,142698,249943
5350,Slovenia,SVN,2000,107264,142661,249925
5351,Slovenia,SVN,2001,107287,142660,249947
5352,Slovenia,SVN,2002,107253,142662,249915
5353,Slovenia,SVN,2003,107281,142672,249953
5354,Slovenia,SVN,2004,107223,142615,249838
5355,Slovenia,SVN,2005,107306,142538,249844
5356,Slovenia,SVN,2006,107319,142384,249703
5357,Slovenia,SVN,2007,107205,142036,249241
5358,Slovenia,SVN,2008,107119,141605,248724
5359,Slovenia,SVN,2009,107053,141224,248277
5360,Slovenia,SVN,2010,107119,141023,248142
5361,Slovenia,SVN,2011,107268,140932,248200
5362,Slovenia,SVN,2012,107336,140816,248152
5363,Slovenia,SVN,2013,107390,140720,248110
5364,Slovenia,SVN,2014,107514,140715,248229
5365,Slovenia,SVN,2015,107682,140778,248460
5366,Slovenia,SVN,2016,107863,140966,248829
5367,Slovenia,SVN,2017,108025,141130,249155
5368,Slovenia,SVN,2018,108083,141330,249413
5369,Slovenia,SVN,2019,108000,141578,249578
5370,Solomon Islands,SLB,1990,18979,17610,36589
5371,Solomon Islands,SLB,1991,19586,18187,37773
5372,Solomon Islands,SLB,1992,20181,18775,38956
5373,Solomon Islands,SLB,1993,20782,19363,40145
5374,Solomon Islands,SLB,1994,21376,19948,41324
5375,Solomon Islands,SLB,1995,21971,20555,42526
5376,Solomon Islands,SLB,1996,22556,21159,43715
5377,Solomon Islands,SLB,1997,23136,21770,44906
5378,Solomon Islands,SLB,1998,23710,22393,46103
5379,Solomon Islands,SLB,1999,24280,23008,47288
5380,Solomon Islands,SLB,2000,24842,23615,48457
5381,Solomon Islands,SLB,2001,25453,24227,49680
5382,Solomon Islands,SLB,2002,26096,24885,50981
5383,Solomon Islands,SLB,2003,26769,25559,52328
5384,Solomon Islands,SLB,2004,27435,26230,53665
5385,Solomon Islands,SLB,2005,28055,26868,54923
5386,Solomon Islands,SLB,2006,28651,27496,56147
5387,Solomon Islands,SLB,2007,29253,28142,57395
5388,Solomon Islands,SLB,2008,29861,28789,58650
5389,Solomon Islands,SLB,2009,30492,29453,59945
5390,Solomon Islands,SLB,2010,31129,30118,61247
5391,Solomon Islands,SLB,2011,31762,30792,62554
5392,Solomon Islands,SLB,2012,32377,31439,63816
5393,Solomon Islands,SLB,2013,33001,32092,65093
5394,Solomon Islands,SLB,2014,33625,32740,66365
5395,Solomon Islands,SLB,2015,34251,33418,67669
5396,Solomon Islands,SLB,2016,34846,34117,68963
5397,Solomon Islands,SLB,2017,35446,34835,70281
5398,Solomon Islands,SLB,2018,36146,35595,71741
5399,Solomon Islands,SLB,2019,36868,36417,73285
5400,Somalia,SOM,1990,427589,414831,842420
5401,Somalia,SOM,1991,433382,422873,856255
5402,Somalia,SOM,1992,455486,443085,898571
5403,Somalia,SOM,1993,476536,462815,939351
5404,Somalia,SOM,1994,497130,482237,979367
5405,Somalia,SOM,1995,519159,502988,1022147
5406,Somalia,SOM,1996,541916,524663,1066579
5407,Somalia,SOM,1997,567970,548982,1116952
5408,Somalia,SOM,1998,596896,575669,1172565
5409,Somalia,SOM,1999,625021,601941,1226962
5410,Somalia,SOM,2000,652659,627647,1280306
5411,Somalia,SOM,2001,681608,654286,1335894
5412,Somalia,SOM,2002,711607,682140,1393747
5413,Somalia,SOM,2003,741266,709373,1450639
5414,Somalia,SOM,2004,769490,736126,1505616
5415,Somalia,SOM,2005,798286,763172,1561458
5416,Somalia,SOM,2006,827027,790456,1617483
5417,Somalia,SOM,2007,853307,815983,1669290
5418,Somalia,SOM,2008,877542,840626,1718168
5419,Somalia,SOM,2009,898799,863357,1762156
5420,Somalia,SOM,2010,917397,884587,1801984
5421,Somalia,SOM,2011,943107,910733,1853840
5422,Somalia,SOM,2012,977900,942777,1920677
5423,Somalia,SOM,2013,1014786,976988,1991774
5424,Somalia,SOM,2014,1053726,1012984,2066710
5425,Somalia,SOM,2015,1097084,1053068,2150152
5426,Somalia,SOM,2016,1141316,1096379,2237695
5427,Somalia,SOM,2017,1185355,1140158,2325513
5428,Somalia,SOM,2018,1231589,1182565,2414154
5429,Somalia,SOM,2019,1281540,1226032,2507572
5430,South Africa,ZAF,1990,1767503,2191058,3958561
5431,South Africa,ZAF,1991,1808343,2237408,4045751
5432,South Africa,ZAF,1992,1849710,2285799,4135509
5433,South Africa,ZAF,1993,1891775,2337431,4229206
5434,South Africa,ZAF,1994,1935491,2393268,4328759
5435,South Africa,ZAF,1995,1980443,2454265,4434708
5436,South Africa,ZAF,1996,2024519,2524358,4548877
5437,South Africa,ZAF,1997,2065481,2603685,4669166
5438,South Africa,ZAF,1998,2104286,2685008,4789294
5439,South Africa,ZAF,1999,2143675,2763815,4907490
5440,South Africa,ZAF,2000,2184978,2831020,5015998
5441,South Africa,ZAF,2001,2228138,2883053,5111191
5442,South Africa,ZAF,2002,2270815,2923485,5194300
5443,South Africa,ZAF,2003,2311676,2955655,5267331
5444,South Africa,ZAF,2004,2350402,2983815,5334217
5445,South Africa,ZAF,2005,2385720,3013606,5399326
5446,South Africa,ZAF,2006,2420598,3041864,5462462
5447,South Africa,ZAF,2007,2456903,3066166,5523069
5448,South Africa,ZAF,2008,2494267,3089847,5584114
5449,South Africa,ZAF,2009,2531678,3117342,5649020
5450,South Africa,ZAF,2010,2567943,3151768,5719711
5451,South Africa,ZAF,2011,2606061,3192581,5798642
5452,South Africa,ZAF,2012,2647035,3237464,5884499
5453,South Africa,ZAF,2013,2691201,3285593,5976794
5454,South Africa,ZAF,2014,2734762,3335040,6069802
5455,South Africa,ZAF,2015,2776717,3385217,6161934
5456,South Africa,ZAF,2016,2819087,3452753,6271840
5457,South Africa,ZAF,2017,2859874,3517378,6377252
5458,South Africa,ZAF,2018,2896971,3554629,6451600
5459,South Africa,ZAF,2019,2933300,3579262,6512562
5460,South Asia (WB),,1990,73457983,70970857,144428840
5461,South Asia (WB),,1991,75292439,72989234,148281673
5462,South Asia (WB),,1992,77160766,75029803,152190569
5463,South Asia (WB),,1993,78972926,76972307,155945233
5464,South Asia (WB),,1994,80674002,78789031,159463033
5465,South Asia (WB),,1995,82298804,80477129,162775933
5466,South Asia (WB),,1996,83743577,81985843,165729420
5467,South Asia (WB),,1997,84964991,83350144,168315135
5468,South Asia (WB),,1998,86080429,84666721,170747150
5469,South Asia (WB),,1999,87262107,86066700,173328807
5470,South Asia (WB),,2000,88711733,87733521,176445254
5471,South Asia (WB),,2001,90488366,89738156,180226522
5472,South Asia (WB),,2002,92473221,91977249,184450470
5473,South Asia (WB),,2003,94521129,94326961,188848090
5474,South Asia (WB),,2004,96547450,96706979,193254429
5475,South Asia (WB),,2005,98457262,98988162,197445424
5476,South Asia (WB),,2006,100020206,100806746,200826952
5477,South Asia (WB),,2007,101322593,102129701,203452294
5478,South Asia (WB),,2008,102506089,103234222,205740311
5479,South Asia (WB),,2009,103765587,104453456,208219043
5480,South Asia (WB),,2010,105334425,106161194,211495619
5481,South Asia (WB),,2011,107163359,108285054,215448413
5482,South Asia (WB),,2012,109042183,110461833,219504016
5483,South Asia (WB),,2013,110919381,112655793,223575174
5484,South Asia (WB),,2014,112751731,114807336,227559067
5485,South Asia (WB),,2015,114515080,116857029,231372109
5486,South Asia (WB),,2016,116256639,118832457,235089096
5487,South Asia (WB),,2017,117958323,120778823,238737146
5488,South Asia (WB),,2018,119482813,122402170,241884983
5489,South Asia (WB),,2019,120839780,123630235,244470015
5490,South Korea,KOR,1990,2404328,2338417,4742745
5491,South Korea,KOR,1991,2415780,2359719,4775499
5492,South Korea,KOR,1992,2418747,2376463,4795210
5493,South Korea,KOR,1993,2420138,2387284,4807422
5494,South Korea,KOR,1994,2417113,2398312,4815425
5495,South Korea,KOR,1995,2415700,2409984,4825684
5496,South Korea,KOR,1996,2417400,2438769,4856169
5497,South Korea,KOR,1997,2419889,2486190,4906079
5498,South Korea,KOR,1998,2423390,2539793,4963183
5499,South Korea,KOR,1999,2427304,2589069,5016373
5500,South Korea,KOR,2000,2432431,2619668,5052099
5501,South Korea,KOR,2001,2436105,2628574,5064679
5502,South Korea,KOR,2002,2436773,2623227,5060000
5503,South Korea,KOR,2003,2438425,2616193,5054618
5504,South Korea,KOR,2004,2442344,2615903,5058247
5505,South Korea,KOR,2005,2451468,2631047,5082515
5506,South Korea,KOR,2006,2467113,2661096,5128209
5507,South Korea,KOR,2007,2487913,2695698,5183611
5508,South Korea,KOR,2008,2513701,2731742,5245443
5509,South Korea,KOR,2009,2542788,2770770,5313558
5510,South Korea,KOR,2010,2570634,2811299,5381933
5511,South Korea,KOR,2011,2596510,2861827,5458337
5512,South Korea,KOR,2012,2623270,2924700,5547970
5513,South Korea,KOR,2013,2650796,2989679,5640475
5514,South Korea,KOR,2014,2677819,3045587,5723406
5515,South Korea,KOR,2015,2704548,3082112,5786660
5516,South Korea,KOR,2016,2713947,3015965,5729912
5517,South Korea,KOR,2017,2722916,2941862,5664778
5518,South Korea,KOR,2018,2743905,2947081,5690986
5519,South Korea,KOR,2019,2761565,2946403,5707968
5520,South Sudan,SSD,1990,318885,306008,624893
5521,South Sudan,SSD,1991,324938,312185,637123
5522,South Sudan,SSD,1992,331114,318880,649994
5523,South Sudan,SSD,1993,337323,325757,663080
5524,South Sudan,SSD,1994,343529,332899,676428
5525,South Sudan,SSD,1995,349831,340485,690316
5526,South Sudan,SSD,1996,356240,348296,704536
5527,South Sudan,SSD,1997,362565,356405,718970
5528,South Sudan,SSD,1998,368886,364638,733524
5529,South Sudan,SSD,1999,375788,373441,749229
5530,South Sudan,SSD,2000,383007,382599,765606
5531,South Sudan,SSD,2001,390890,392245,783135
5532,South Sudan,SSD,2002,399271,402315,801586
5533,South Sudan,SSD,2003,408269,412859,821128
5534,South Sudan,SSD,2004,417624,423838,841462
5535,South Sudan,SSD,2005,427493,435309,862802
5536,South Sudan,SSD,2006,437583,447318,884901
5537,South Sudan,SSD,2007,448163,459842,908005
5538,South Sudan,SSD,2008,458963,472847,931810
5539,South Sudan,SSD,2009,470626,486571,957197
5540,South Sudan,SSD,2010,482762,500623,983385
5541,South Sudan,SSD,2011,495631,515391,1011022
5542,South Sudan,SSD,2012,502581,525549,1028130
5543,South Sudan,SSD,2013,501331,529308,1030639
5544,South Sudan,SSD,2014,495053,528649,1023702
5545,South Sudan,SSD,2015,471407,513815,985222
5546,South Sudan,SSD,2016,448088,498078,946166
5547,South Sudan,SSD,2017,451438,504400,955838
5548,South Sudan,SSD,2018,467181,520643,987824
5549,South Sudan,SSD,2019,481335,534545,1015880
5550,South-East Asia Region (WHO),,1990,82348055,81876016,164224071
5551,South-East Asia Region (WHO),,1991,84177895,83966535,168144430
5552,South-East Asia Region (WHO),,1992,85966166,86015587,171981753
5553,South-East Asia Region (WHO),,1993,87728811,87989262,175718073
5554,South-East Asia Region (WHO),,1994,89427697,89874814,179302511
5555,South-East Asia Region (WHO),,1995,91046300,91618165,182664465
5556,South-East Asia Region (WHO),,1996,92469137,93163033,185632170
5557,South-East Asia Region (WHO),,1997,93653242,94540082,188193324
5558,South-East Asia Region (WHO),,1998,94751428,95868834,190620262
5559,South-East Asia Region (WHO),,1999,95928054,97290459,193218513
5560,South-East Asia Region (WHO),,2000,97358117,98965750,196323867
5561,South-East Asia Region (WHO),,2001,99067028,100942986,200010014
5562,South-East Asia Region (WHO),,2002,100935687,103110778,204046465
5563,South-East Asia Region (WHO),,2003,102881256,105399380,208280636
5564,South-East Asia Region (WHO),,2004,104803323,107706584,212509907
5565,South-East Asia Region (WHO),,2005,106597020,109903806,216500826
5566,South-East Asia Region (WHO),,2006,108129912,111679226,219809138
5567,South-East Asia Region (WHO),,2007,109427118,112962752,222389870
5568,South-East Asia Region (WHO),,2008,110462619,113925590,224388209
5569,South-East Asia Region (WHO),,2009,111442913,114919342,226362255
5570,South-East Asia Region (WHO),,2010,112764079,116428383,229192462
5571,South-East Asia Region (WHO),,2011,114378755,118398064,232776819
5572,South-East Asia Region (WHO),,2012,116005387,120425041,236430428
5573,South-East Asia Region (WHO),,2013,117622239,122468508,240090747
5574,South-East Asia Region (WHO),,2014,119207080,124466964,243674044
5575,South-East Asia Region (WHO),,2015,120748420,126360124,247108544
5576,South-East Asia Region (WHO),,2016,122240436,128151757,250392193
5577,South-East Asia Region (WHO),,2017,123670322,129892005,253562327
5578,South-East Asia Region (WHO),,2018,124916635,131273631,256190266
5579,South-East Asia Region (WHO),,2019,125976154,132214674,258190828
5580,Spain,ESP,1990,2861916,3597882,6459798
5581,Spain,ESP,1991,2856475,3602029,6458504
5582,Spain,ESP,1992,2851141,3606053,6457194
5583,Spain,ESP,1993,2845653,3608454,6454107
5584,Spain,ESP,1994,2843211,3613019,6456230
5585,Spain,ESP,1995,2843418,3619677,6463095
5586,Spain,ESP,1996,2845608,3618345,6463953
5587,Spain,ESP,1997,2850190,3603069,6453259
5588,Spain,ESP,1998,2858311,3584634,6442945
5589,Spain,ESP,1999,2873777,3577174,6450951
5590,Spain,ESP,2000,2897645,3595932,6493577
5591,Spain,ESP,2001,2935540,3648900,6584440
5592,Spain,ESP,2002,2984270,3730852,6715122
5593,Spain,ESP,2003,3039378,3832478,6871856
5594,Spain,ESP,2004,3095228,3939138,7034366
5595,Spain,ESP,2005,3145186,4046442,7191628
5596,Spain,ESP,2006,3197788,4175805,7373593
5597,Spain,ESP,2007,3257148,4341462,7598610
5598,Spain,ESP,2008,3317527,4515618,7833145
5599,Spain,ESP,2009,3366137,4663896,8030033
5600,Spain,ESP,2010,3395566,4753112,8148678
5601,Spain,ESP,2011,3407712,4794631,8202343
5602,Spain,ESP,2012,3409814,4817993,8227807
5603,Spain,ESP,2013,3401680,4825642,8227322
5604,Spain,ESP,2014,3392360,4825351,8217711
5605,Spain,ESP,2015,3380644,4821808,8202452
5606,Spain,ESP,2016,3368190,4821596,8189786
5607,Spain,ESP,2017,3357499,4820352,8177851
5608,Spain,ESP,2018,3354747,4734688,8089435
5609,Spain,ESP,2019,3362193,4559185,7921378
5610,Sri Lanka,LKA,1990,956802,1059637,2016439
5611,Sri Lanka,LKA,1991,966587,1075253,2041840
5612,Sri Lanka,LKA,1992,975584,1090098,2065682
5613,Sri Lanka,LKA,1993,984805,1104593,2089398
5614,Sri Lanka,LKA,1994,992886,1118477,2111363
5615,Sri Lanka,LKA,1995,999939,1131855,2131794
5616,Sri Lanka,LKA,1996,1004427,1142917,2147344
5617,Sri Lanka,LKA,1997,1006287,1150641,2156928
5618,Sri Lanka,LKA,1998,1006990,1156540,2163530
5619,Sri Lanka,LKA,1999,1007306,1162591,2169897
5620,Sri Lanka,LKA,2000,1008249,1170227,2178476
5621,Sri Lanka,LKA,2001,1010056,1179514,2189570
5622,Sri Lanka,LKA,2002,1012623,1189833,2202456
5623,Sri Lanka,LKA,2003,1016014,1200406,2216420
5624,Sri Lanka,LKA,2004,1018006,1209857,2227863
5625,Sri Lanka,LKA,2005,1020627,1218353,2238980
5626,Sri Lanka,LKA,2006,1025067,1226498,2251565
5627,Sri Lanka,LKA,2007,1029608,1234227,2263835
5628,Sri Lanka,LKA,2008,1034086,1242077,2276163
5629,Sri Lanka,LKA,2009,1038721,1250070,2288791
5630,Sri Lanka,LKA,2010,1044812,1259507,2304319
5631,Sri Lanka,LKA,2011,1052839,1269989,2322828
5632,Sri Lanka,LKA,2012,1061523,1281776,2343299
5633,Sri Lanka,LKA,2013,1070650,1294327,2364977
5634,Sri Lanka,LKA,2014,1080457,1306249,2386706
5635,Sri Lanka,LKA,2015,1089654,1318749,2408403
5636,Sri Lanka,LKA,2016,1097427,1333519,2430946
5637,Sri Lanka,LKA,2017,1105392,1347873,2453265
5638,Sri Lanka,LKA,2018,1114574,1359545,2474119
5639,Sri Lanka,LKA,2019,1125379,1370413,2495792
5640,Sub-Saharan Africa (WB),,1990,25976794,27812121,53788915
5641,Sub-Saharan Africa (WB),,1991,26780916,28619212,55400128
5642,Sub-Saharan Africa (WB),,1992,27581867,29417554,56999421
5643,Sub-Saharan Africa (WB),,1993,28406703,30238962,58645665
5644,Sub-Saharan Africa (WB),,1994,29293133,31149875,60443008
5645,Sub-Saharan Africa (WB),,1995,30213283,32118525,62331808
5646,Sub-Saharan Africa (WB),,1996,31179314,33165980,64345294
5647,Sub-Saharan Africa (WB),,1997,32165370,34278717,66444087
5648,Sub-Saharan Africa (WB),,1998,33141529,35396409,68537938
5649,Sub-Saharan Africa (WB),,1999,34122904,36509925,70632829
5650,Sub-Saharan Africa (WB),,2000,35101965,37578197,72680162
5651,Sub-Saharan Africa (WB),,2001,36087777,38596526,74684303
5652,Sub-Saharan Africa (WB),,2002,37082919,39596300,76679219
5653,Sub-Saharan Africa (WB),,2003,38091612,40600036,78691648
5654,Sub-Saharan Africa (WB),,2004,39118742,41630171,80748913
5655,Sub-Saharan Africa (WB),,2005,40164159,42711575,82875734
5656,Sub-Saharan Africa (WB),,2006,41214457,43816190,85030647
5657,Sub-Saharan Africa (WB),,2007,42266634,44915279,87181913
5658,Sub-Saharan Africa (WB),,2008,43327884,46027238,89355122
5659,Sub-Saharan Africa (WB),,2009,44404461,47165774,91570235
5660,Sub-Saharan Africa (WB),,2010,45500404,48353641,93854045
5661,Sub-Saharan Africa (WB),,2011,46618807,49574264,96193071
5662,Sub-Saharan Africa (WB),,2012,47751980,50814226,98566206
5663,Sub-Saharan Africa (WB),,2013,48910177,52085677,100995854
5664,Sub-Saharan Africa (WB),,2014,50110053,53441347,103551400
5665,Sub-Saharan Africa (WB),,2015,51393771,54924492,106318263
5666,Sub-Saharan Africa (WB),,2016,52756026,56569528,109325554
5667,Sub-Saharan Africa (WB),,2017,54193510,58287568,112481078
5668,Sub-Saharan Africa (WB),,2018,55712179,59988657,115700836
5669,Sub-Saharan Africa (WB),,2019,57296795,61682062,118978857
5670,Sudan,SDN,1990,1512382,1545475,3057857
5671,Sudan,SDN,1991,1576850,1608923,3185773
5672,Sudan,SDN,1992,1637372,1669331,3306703
5673,Sudan,SDN,1993,1691929,1725523,3417452
5674,Sudan,SDN,1994,1740819,1775753,3516572
5675,Sudan,SDN,1995,1784358,1820492,3604850
5676,Sudan,SDN,1996,1835217,1870797,3706014
5677,Sudan,SDN,1997,1889843,1923507,3813350
5678,Sudan,SDN,1998,1938425,1971814,3910239
5679,Sudan,SDN,1999,1986136,2018659,4004795
5680,Sudan,SDN,2000,2031267,2062454,4093721
5681,Sudan,SDN,2001,2067843,2101283,4169126
5682,Sudan,SDN,2002,2095274,2131739,4227013
5683,Sudan,SDN,2003,2126151,2164717,4290868
5684,Sudan,SDN,2004,2165752,2204566,4370318
5685,Sudan,SDN,2005,2210981,2249183,4460164
5686,Sudan,SDN,2006,2257281,2296488,4553769
5687,Sudan,SDN,2007,2307818,2345406,4653224
5688,Sudan,SDN,2008,2357087,2395294,4752381
5689,Sudan,SDN,2009,2400322,2439208,4839530
5690,Sudan,SDN,2010,2438118,2480658,4918776
5691,Sudan,SDN,2011,2482497,2528221,5010718
5692,Sudan,SDN,2012,2534097,2580322,5114419
5693,Sudan,SDN,2013,2591851,2637951,5229802
5694,Sudan,SDN,2014,2652070,2699302,5351372
5695,Sudan,SDN,2015,2721945,2771219,5493164
5696,Sudan,SDN,2016,2799343,2850437,5649780
5697,Sudan,SDN,2017,2866999,2925740,5792739
5698,Sudan,SDN,2018,2929018,2998918,5927936
5699,Sudan,SDN,2019,2990043,3078601,6068644
5700,Suriname,SUR,1990,28063,27633,55696
5701,Suriname,SUR,1991,28204,27820,56024
5702,Suriname,SUR,1992,28383,28070,56453
5703,Suriname,SUR,1993,28560,28336,56896
5704,Suriname,SUR,1994,28865,28711,57576
5705,Suriname,SUR,1995,29447,29300,58747
5706,Suriname,SUR,1996,30132,29985,60117
5707,Suriname,SUR,1997,30868,30761,61629
5708,Suriname,SUR,1998,31626,31588,63214
5709,Suriname,SUR,1999,32484,32484,64968
5710,Suriname,SUR,2000,33401,33448,66849
5711,Suriname,SUR,2001,34375,34444,68819
5712,Suriname,SUR,2002,35403,35480,70883
5713,Suriname,SUR,2003,36408,36513,72921
5714,Suriname,SUR,2004,37296,37477,74773
5715,Suriname,SUR,2005,38057,38346,76403
5716,Suriname,SUR,2006,38677,39106,77783
5717,Suriname,SUR,2007,39158,39771,78929
5718,Suriname,SUR,2008,39555,40344,79899
5719,Suriname,SUR,2009,39896,40880,80776
5720,Suriname,SUR,2010,40351,41490,81841
5721,Suriname,SUR,2011,40822,42129,82951
5722,Suriname,SUR,2012,41188,42684,83872
5723,Suriname,SUR,2013,41441,43157,84598
5724,Suriname,SUR,2014,41598,43560,85158
5725,Suriname,SUR,2015,41756,43945,85701
5726,Suriname,SUR,2016,41885,44350,86235
5727,Suriname,SUR,2017,42010,44746,86756
5728,Suriname,SUR,2018,42191,45059,87250
5729,Suriname,SUR,2019,42382,45274,87656
5730,Sweden,SWE,1990,548502,718966,1267468
5731,Sweden,SWE,1991,551198,723413,1274611
5732,Sweden,SWE,1992,553848,727199,1281047
5733,Sweden,SWE,1993,556399,730949,1287348
5734,Sweden,SWE,1994,558898,734144,1293042
5735,Sweden,SWE,1995,561548,737312,1298860
5736,Sweden,SWE,1996,563847,739856,1303703
5737,Sweden,SWE,1997,565767,742033,1307800
5738,Sweden,SWE,1998,567740,744554,1312294
5739,Sweden,SWE,1999,569878,747146,1317024
5740,Sweden,SWE,2000,572474,750132,1322606
5741,Sweden,SWE,2001,575293,753304,1328597
5742,Sweden,SWE,2002,578623,756517,1335140
5743,Sweden,SWE,2003,582023,760081,1342104
5744,Sweden,SWE,2004,585492,764116,1349608
5745,Sweden,SWE,2005,589010,768284,1357294
5746,Sweden,SWE,2006,592546,772999,1365545
5747,Sweden,SWE,2007,596519,777717,1374236
5748,Sweden,SWE,2008,600745,782887,1383632
5749,Sweden,SWE,2009,605312,788130,1393442
5750,Sweden,SWE,2010,609947,793219,1403166
5751,Sweden,SWE,2011,614944,797878,1412822
5752,Sweden,SWE,2012,620487,802255,1422742
5753,Sweden,SWE,2013,626486,806714,1433200
5754,Sweden,SWE,2014,632778,811241,1444019
5755,Sweden,SWE,2015,639429,816581,1456010
5756,Sweden,SWE,2016,645652,822162,1467814
5757,Sweden,SWE,2017,651333,827671,1479004
5758,Sweden,SWE,2018,658712,833528,1492240
5759,Sweden,SWE,2019,668237,839390,1507627
5760,Switzerland,CHE,1990,506847,645936,1152783
5761,Switzerland,CHE,1991,509725,649425,1159150
5762,Switzerland,CHE,1992,512327,652922,1165249
5763,Switzerland,CHE,1993,514564,656356,1170920
5764,Switzerland,CHE,1994,516455,659596,1176051
5765,Switzerland,CHE,1995,518333,662933,1181266
5766,Switzerland,CHE,1996,520068,666430,1186498
5767,Switzerland,CHE,1997,521834,670323,1192157
5768,Switzerland,CHE,1998,523675,674148,1197823
5769,Switzerland,CHE,1999,525663,678101,1203764
5770,Switzerland,CHE,2000,527640,681597,1209237
5771,Switzerland,CHE,2001,528102,681072,1209174
5772,Switzerland,CHE,2002,526483,674716,1201199
5773,Switzerland,CHE,2003,524144,666564,1190708
5774,Switzerland,CHE,2004,523333,660557,1183890
5775,Switzerland,CHE,2005,526047,661749,1187796
5776,Switzerland,CHE,2006,533981,672693,1206674
5777,Switzerland,CHE,2007,545327,690622,1235949
5778,Switzerland,CHE,2008,558493,711133,1269626
5779,Switzerland,CHE,2009,570794,729458,1300252
5780,Switzerland,CHE,2010,579866,741431,1321297
5781,Switzerland,CHE,2011,586444,748151,1334595
5782,Switzerland,CHE,2012,592842,754334,1347176
5783,Switzerland,CHE,2013,598879,760528,1359407
5784,Switzerland,CHE,2014,605366,766665,1372031
5785,Switzerland,CHE,2015,611789,773062,1384851
5786,Switzerland,CHE,2016,618896,778186,1397082
5787,Switzerland,CHE,2017,625811,783183,1408994
5788,Switzerland,CHE,2018,632409,789060,1421469
5789,Switzerland,CHE,2019,638800,795324,1434124
5790,Syria,SYR,1990,898760,904318,1803078
5791,Syria,SYR,1991,928945,936672,1865617
5792,Syria,SYR,1992,959946,970053,1929999
5793,Syria,SYR,1993,990188,1002430,1992618
5794,Syria,SYR,1994,1018812,1034039,2052851
5795,Syria,SYR,1995,1046727,1064561,2111288
5796,Syria,SYR,1996,1074070,1094133,2168203
5797,Syria,SYR,1997,1100909,1122623,2223532
5798,Syria,SYR,1998,1126640,1150398,2277038
5799,Syria,SYR,1999,1152236,1177579,2329815
5800,Syria,SYR,2000,1176616,1204774,2381390
5801,Syria,SYR,2001,1199846,1231567,2431413
5802,Syria,SYR,2002,1230050,1264846,2494896
5803,Syria,SYR,2003,1266634,1303665,2570299
5804,Syria,SYR,2004,1311652,1349120,2660772
5805,Syria,SYR,2005,1380684,1413488,2794172
5806,Syria,SYR,2006,1444602,1473376,2917978
5807,Syria,SYR,2007,1466764,1500153,2966917
5808,Syria,SYR,2008,1478704,1518973,2997677
5809,Syria,SYR,2009,1495315,1541002,3036317
5810,Syria,SYR,2010,1487817,1545587,3033404
5811,Syria,SYR,2011,1419598,1502111,2921709
5812,Syria,SYR,2012,1298496,1416414,2714910
5813,Syria,SYR,2013,1192830,1337367,2530197
5814,Syria,SYR,2014,1123074,1284300,2407374
5815,Syria,SYR,2015,1076747,1249566,2326313
5816,Syria,SYR,2016,1042295,1225296,2267591
5817,Syria,SYR,2017,1026293,1217742,2244035
5818,Syria,SYR,2018,1033024,1233847,2266871
5819,Syria,SYR,2019,1047029,1260959,2307988
5820,Taiwan,TWN,1990,1040385,1067760,2108145
5821,Taiwan,TWN,1991,1044831,1075537,2120368
5822,Taiwan,TWN,1992,1050324,1084687,2135011
5823,Taiwan,TWN,1993,1055855,1095046,2150901
5824,Taiwan,TWN,1994,1062389,1107236,2169625
5825,Taiwan,TWN,1995,1069360,1120932,2190292
5826,Taiwan,TWN,1996,1075876,1136348,2212224
5827,Taiwan,TWN,1997,1082238,1154643,2236881
5828,Taiwan,TWN,1998,1089262,1174233,2263495
5829,Taiwan,TWN,1999,1096498,1193446,2289944
5830,Taiwan,TWN,2000,1103878,1211371,2315249
5831,Taiwan,TWN,2001,1111935,1226392,2338327
5832,Taiwan,TWN,2002,1119236,1239102,2358338
5833,Taiwan,TWN,2003,1125541,1251808,2377349
5834,Taiwan,TWN,2004,1132568,1264891,2397459
5835,Taiwan,TWN,2005,1139610,1279813,2419423
5836,Taiwan,TWN,2006,1145700,1296262,2441962
5837,Taiwan,TWN,2007,1149859,1311519,2461378
5838,Taiwan,TWN,2008,1153130,1324584,2477714
5839,Taiwan,TWN,2009,1155888,1338773,2494661
5840,Taiwan,TWN,2010,1159486,1352562,2512048
5841,Taiwan,TWN,2011,1162480,1366945,2529425
5842,Taiwan,TWN,2012,1165140,1380951,2546091
5843,Taiwan,TWN,2013,1167859,1393081,2560940
5844,Taiwan,TWN,2014,1169854,1404352,2574206
5845,Taiwan,TWN,2015,1169616,1413396,2583012
5846,Taiwan,TWN,2016,1167667,1415597,2583264
5847,Taiwan,TWN,2017,1165793,1416517,2582310
5848,Taiwan,TWN,2018,1166157,1423610,2589767
5849,Taiwan,TWN,2019,1165566,1433079,2598645
5850,Tajikistan,TJK,1990,244527,248141,492668
5851,Tajikistan,TJK,1991,251344,254024,505368
5852,Tajikistan,TJK,1992,258166,259948,518114
5853,Tajikistan,TJK,1993,264740,265637,530377
5854,Tajikistan,TJK,1994,271737,271372,543109
5855,Tajikistan,TJK,1995,279831,277749,557580
5856,Tajikistan,TJK,1996,289314,285319,574633
5857,Tajikistan,TJK,1997,300226,293794,594020
5858,Tajikistan,TJK,1998,311490,302395,613885
5859,Tajikistan,TJK,1999,322121,310413,632534
5860,Tajikistan,TJK,2000,330842,317364,648206
5861,Tajikistan,TJK,2001,338305,323822,662127
5862,Tajikistan,TJK,2002,345574,330431,676005
5863,Tajikistan,TJK,2003,352696,337310,690006
5864,Tajikistan,TJK,2004,359995,344607,704602
5865,Tajikistan,TJK,2005,367905,352372,720277
5866,Tajikistan,TJK,2006,374735,359861,734596
5867,Tajikistan,TJK,2007,381463,366865,748328
5868,Tajikistan,TJK,2008,387861,373599,761460
5869,Tajikistan,TJK,2009,394425,380909,775334
5870,Tajikistan,TJK,2010,401606,388860,790466
5871,Tajikistan,TJK,2011,409167,397313,806480
5872,Tajikistan,TJK,2012,416894,406313,823207
5873,Tajikistan,TJK,2013,425052,415444,840496
5874,Tajikistan,TJK,2014,433411,424737,858148
5875,Tajikistan,TJK,2015,441754,433997,875751
5876,Tajikistan,TJK,2016,449948,442770,892718
5877,Tajikistan,TJK,2017,458783,451919,910702
5878,Tajikistan,TJK,2018,468486,462104,930590
5879,Tajikistan,TJK,2019,478926,473144,952070
5880,Tanzania,TZA,1990,1275480,1443047,2718527
5881,Tanzania,TZA,1991,1319378,1489887,2809265
5882,Tanzania,TZA,1992,1363421,1536747,2900168
5883,Tanzania,TZA,1993,1408117,1584822,2992939
5884,Tanzania,TZA,1994,1453047,1632713,3085760
5885,Tanzania,TZA,1995,1497654,1680986,3178640
5886,Tanzania,TZA,1996,1542082,1729386,3271468
5887,Tanzania,TZA,1997,1585499,1778718,3364217
5888,Tanzania,TZA,1998,1630009,1827660,3457669
5889,Tanzania,TZA,1999,1674366,1877178,3551544
5890,Tanzania,TZA,2000,1719235,1928294,3647529
5891,Tanzania,TZA,2001,1764296,1976977,3741273
5892,Tanzania,TZA,2002,1808283,2023570,3831853
5893,Tanzania,TZA,2003,1851466,2070453,3921919
5894,Tanzania,TZA,2004,1896204,2118487,4014691
5895,Tanzania,TZA,2005,1941310,2168629,4109939
5896,Tanzania,TZA,2006,1987713,2221037,4208750
5897,Tanzania,TZA,2007,2034864,2276705,4311569
5898,Tanzania,TZA,2008,2083188,2334590,4417778
5899,Tanzania,TZA,2009,2133842,2395628,4529470
5900,Tanzania,TZA,2010,2186514,2459453,4645967
5901,Tanzania,TZA,2011,2242830,2528144,4770974
5902,Tanzania,TZA,2012,2302521,2598983,4901504
5903,Tanzania,TZA,2013,2364645,2671453,5036098
5904,Tanzania,TZA,2014,2430300,2749471,5179771
5905,Tanzania,TZA,2015,2495939,2829476,5325415
5906,Tanzania,TZA,2016,2561431,2915091,5476522
5907,Tanzania,TZA,2017,2630868,3002562,5633430
5908,Tanzania,TZA,2018,2706903,3090407,5797310
5909,Tanzania,TZA,2019,2787711,3177410,5965121
5910,Thailand,THA,1990,3664917,3423858,7088775
5911,Thailand,THA,1991,3695127,3477501,7172628
5912,Thailand,THA,1992,3722754,3530065,7252819
5913,Thailand,THA,1993,3748071,3576465,7324536
5914,Thailand,THA,1994,3767299,3621044,7388343
5915,Thailand,THA,1995,3788579,3665218,7453797
5916,Thailand,THA,1996,3811274,3708927,7520201
5917,Thailand,THA,1997,3830973,3749524,7580497
5918,Thailand,THA,1998,3853147,3788924,7642071
5919,Thailand,THA,1999,3872457,3827903,7700360
5920,Thailand,THA,2000,3893752,3864606,7758358
5921,Thailand,THA,2001,3918206,3904047,7822253
5922,Thailand,THA,2002,3946001,3945684,7891685
5923,Thailand,THA,2003,3971980,3989265,7961245
5924,Thailand,THA,2004,3998827,4032841,8031668
5925,Thailand,THA,2005,4022497,4074466,8096963
5926,Thailand,THA,2006,4104261,4156983,8261244
5927,Thailand,THA,2007,4246085,4283848,8529933
5928,Thailand,THA,2008,4271414,4331482,8602896
5929,Thailand,THA,2009,4174825,4298192,8473017
5930,Thailand,THA,2010,4129800,4297485,8427285
5931,Thailand,THA,2011,4141401,4331240,8472641
5932,Thailand,THA,2012,4147076,4360134,8507210
5933,Thailand,THA,2013,4150132,4384436,8534568
5934,Thailand,THA,2014,4150642,4405679,8556321
5935,Thailand,THA,2015,4155800,4435462,8591262
5936,Thailand,THA,2016,4162967,4465555,8628522
5937,Thailand,THA,2017,4165089,4493166,8658255
5938,Thailand,THA,2018,4167508,4516668,8684176
5939,Thailand,THA,2019,4171085,4536545,8707630
5940,Timor,TLS,1990,41191,42358,83549
5941,Timor,TLS,1991,42000,43134,85134
5942,Timor,TLS,1992,42681,43817,86498
5943,Timor,TLS,1993,43265,44466,87731
5944,Timor,TLS,1994,43723,45071,88794
5945,Timor,TLS,1995,44142,45643,89785
5946,Timor,TLS,1996,44484,46191,90675
5947,Timor,TLS,1997,44792,46716,91508
5948,Timor,TLS,1998,45011,47201,92212
5949,Timor,TLS,1999,45190,47677,92867
5950,Timor,TLS,2000,45454,48185,93639
5951,Timor,TLS,2001,45920,48774,94694
5952,Timor,TLS,2002,46487,49485,95972
5953,Timor,TLS,2003,47157,50216,97373
5954,Timor,TLS,2004,47957,51035,98992
5955,Timor,TLS,2005,48910,51892,100802
5956,Timor,TLS,2006,49840,52620,102460
5957,Timor,TLS,2007,50643,53175,103818
5958,Timor,TLS,2008,51478,53726,105204
5959,Timor,TLS,2009,52404,54418,106822
5960,Timor,TLS,2010,53595,55519,109114
5961,Timor,TLS,2011,54946,56885,111831
5962,Timor,TLS,2012,56297,58345,114642
5963,Timor,TLS,2013,57642,59887,117529
5964,Timor,TLS,2014,59032,61489,120521
5965,Timor,TLS,2015,60308,63084,123392
5966,Timor,TLS,2016,61622,64882,126504
5967,Timor,TLS,2017,63007,66693,129700
5968,Timor,TLS,2018,64502,68488,132990
5969,Timor,TLS,2019,66123,70303,136426
5970,Togo,TGO,1990,171942,191228,363170
5971,Togo,TGO,1991,178084,197980,376064
5972,Togo,TGO,1992,184350,205002,389352
5973,Togo,TGO,1993,190663,212162,402825
5974,Togo,TGO,1994,197218,219465,416683
5975,Togo,TGO,1995,203695,226960,430655
5976,Togo,TGO,1996,210240,234597,444837
5977,Togo,TGO,1997,216981,242369,459350
5978,Togo,TGO,1998,223720,250340,474060
5979,Togo,TGO,1999,230663,258459,489122
5980,Togo,TGO,2000,237828,266515,504343
5981,Togo,TGO,2001,245323,274772,520095
5982,Togo,TGO,2002,253277,283097,536374
5983,Togo,TGO,2003,261431,291736,553167
5984,Togo,TGO,2004,269789,300400,570189
5985,Togo,TGO,2005,277987,309328,587315
5986,Togo,TGO,2006,286434,318500,604934
5987,Togo,TGO,2007,295185,328118,623303
5988,Togo,TGO,2008,304271,337934,642205
5989,Togo,TGO,2009,313197,347882,661079
5990,Togo,TGO,2010,322463,358196,680659
5991,Togo,TGO,2011,331664,368311,699975
5992,Togo,TGO,2012,341097,378500,719597
5993,Togo,TGO,2013,350249,388909,739158
5994,Togo,TGO,2014,359686,399522,759208
5995,Togo,TGO,2015,369130,410376,779506
5996,Togo,TGO,2016,379124,421260,800384
5997,Togo,TGO,2017,389254,432798,822052
5998,Togo,TGO,2018,399218,444837,844055
5999,Togo,TGO,2019,409204,457367,866571
6000,Tokelau,TKL,1990,85,92,177
6001,Tokelau,TKL,1991,83,90,173
6002,Tokelau,TKL,1992,82,89,171
6003,Tokelau,TKL,1993,81,88,169
6004,Tokelau,TKL,1994,80,87,167
6005,Tokelau,TKL,1995,80,86,166
6006,Tokelau,TKL,1996,80,86,166
6007,Tokelau,TKL,1997,80,86,166
6008,Tokelau,TKL,1998,80,88,168
6009,Tokelau,TKL,1999,81,89,170
6010,Tokelau,TKL,2000,81,90,171
6011,Tokelau,TKL,2001,80,89,169
6012,Tokelau,TKL,2002,77,85,162
6013,Tokelau,TKL,2003,74,80,154
6014,Tokelau,TKL,2004,71,74,145
6015,Tokelau,TKL,2005,68,70,138
6016,Tokelau,TKL,2006,66,67,133
6017,Tokelau,TKL,2007,65,66,131
6018,Tokelau,TKL,2008,65,67,132
6019,Tokelau,TKL,2009,66,68,134
6020,Tokelau,TKL,2010,67,70,137
6021,Tokelau,TKL,2011,68,71,139
6022,Tokelau,TKL,2012,69,71,140
6023,Tokelau,TKL,2013,70,72,142
6024,Tokelau,TKL,2014,71,72,143
6025,Tokelau,TKL,2015,71,73,144
6026,Tokelau,TKL,2016,72,74,146
6027,Tokelau,TKL,2017,73,75,148
6028,Tokelau,TKL,2018,75,77,152
6029,Tokelau,TKL,2019,76,78,154
6030,Tonga,TON,1990,4963,5090,10053
6031,Tonga,TON,1991,4973,5103,10076
6032,Tonga,TON,1992,4987,5116,10103
6033,Tonga,TON,1993,5006,5131,10137
6034,Tonga,TON,1994,5026,5150,10176
6035,Tonga,TON,1995,5053,5171,10224
6036,Tonga,TON,1996,5079,5196,10275
6037,Tonga,TON,1997,5110,5224,10334
6038,Tonga,TON,1998,5144,5253,10397
6039,Tonga,TON,1999,5174,5285,10459
6040,Tonga,TON,2000,5203,5317,10520
6041,Tonga,TON,2001,5236,5345,10581
6042,Tonga,TON,2002,5264,5373,10637
6043,Tonga,TON,2003,5292,5404,10696
6044,Tonga,TON,2004,5318,5434,10752
6045,Tonga,TON,2005,5343,5468,10811
6046,Tonga,TON,2006,5370,5502,10872
6047,Tonga,TON,2007,5396,5537,10933
6048,Tonga,TON,2008,5416,5572,10988
6049,Tonga,TON,2009,5428,5602,11030
6050,Tonga,TON,2010,5429,5627,11056
6051,Tonga,TON,2011,5428,5646,11074
6052,Tonga,TON,2012,5417,5656,11073
6053,Tonga,TON,2013,5399,5659,11058
6054,Tonga,TON,2014,5372,5655,11027
6055,Tonga,TON,2015,5343,5650,10993
6056,Tonga,TON,2016,5303,5643,10946
6057,Tonga,TON,2017,5265,5639,10904
6058,Tonga,TON,2018,5245,5644,10889
6059,Tonga,TON,2019,5231,5660,10891
6060,Trinidad and Tobago,TTO,1990,84045,81695,165740
6061,Trinidad and Tobago,TTO,1991,85230,82700,167930
6062,Trinidad and Tobago,TTO,1992,86453,83794,170247
6063,Trinidad and Tobago,TTO,1993,87673,84955,172628
6064,Trinidad and Tobago,TTO,1994,88866,86122,174988
6065,Trinidad and Tobago,TTO,1995,90045,87346,177391
6066,Trinidad and Tobago,TTO,1996,91175,88541,179716
6067,Trinidad and Tobago,TTO,1997,92201,89729,181930
6068,Trinidad and Tobago,TTO,1998,93091,90844,183935
6069,Trinidad and Tobago,TTO,1999,93848,91808,185656
6070,Trinidad and Tobago,TTO,2000,94499,92708,187207
6071,Trinidad and Tobago,TTO,2001,95061,93444,188505
6072,Trinidad and Tobago,TTO,2002,95476,94053,189529
6073,Trinidad and Tobago,TTO,2003,95789,94451,190240
6074,Trinidad and Tobago,TTO,2004,96030,94815,190845
6075,Trinidad and Tobago,TTO,2005,96193,95160,191353
6076,Trinidad and Tobago,TTO,2006,96325,95477,191802
6077,Trinidad and Tobago,TTO,2007,96443,95747,192190
6078,Trinidad and Tobago,TTO,2008,96527,95952,192479
6079,Trinidad and Tobago,TTO,2009,96589,96223,192812
6080,Trinidad and Tobago,TTO,2010,96745,96527,193272
6081,Trinidad and Tobago,TTO,2011,97011,96992,194003
6082,Trinidad and Tobago,TTO,2012,97417,97579,194996
6083,Trinidad and Tobago,TTO,2013,97855,98193,196048
6084,Trinidad and Tobago,TTO,2014,98277,98814,197091
6085,Trinidad and Tobago,TTO,2015,98633,99323,197956
6086,Trinidad and Tobago,TTO,2016,98868,99754,198622
6087,Trinidad and Tobago,TTO,2017,99098,100116,199214
6088,Trinidad and Tobago,TTO,2018,99425,100624,200049
6089,Trinidad and Tobago,TTO,2019,99859,101253,201112
6090,Tunisia,TUN,1990,606987,649008,1255995
6091,Tunisia,TUN,1991,620814,666605,1287419
6092,Tunisia,TUN,1992,634565,684159,1318724
6093,Tunisia,TUN,1993,647851,701091,1348942
6094,Tunisia,TUN,1994,660436,717431,1377867
6095,Tunisia,TUN,1995,672701,733133,1405834
6096,Tunisia,TUN,1996,684135,747625,1431760
6097,Tunisia,TUN,1997,695167,761592,1456759
6098,Tunisia,TUN,1998,705748,774916,1480664
6099,Tunisia,TUN,1999,715596,787982,1503578
6100,Tunisia,TUN,2000,724424,800802,1525226
6101,Tunisia,TUN,2001,732510,813824,1546334
6102,Tunisia,TUN,2002,739412,826552,1565964
6103,Tunisia,TUN,2003,746365,838613,1584978
6104,Tunisia,TUN,2004,751955,850508,1602463
6105,Tunisia,TUN,2005,757248,861564,1618812
6106,Tunisia,TUN,2006,762304,871438,1633742
6107,Tunisia,TUN,2007,767042,880687,1647729
6108,Tunisia,TUN,2008,771834,889393,1661227
6109,Tunisia,TUN,2009,776349,897661,1674010
6110,Tunisia,TUN,2010,781190,905818,1687008
6111,Tunisia,TUN,2011,786353,914680,1701033
6112,Tunisia,TUN,2012,791745,924625,1716370
6113,Tunisia,TUN,2013,797580,934636,1732216
6114,Tunisia,TUN,2014,803580,944328,1747908
6115,Tunisia,TUN,2015,809871,953166,1763037
6116,Tunisia,TUN,2016,814952,960459,1775411
6117,Tunisia,TUN,2017,820341,967444,1787785
6118,Tunisia,TUN,2018,827652,978423,1806075
6119,Tunisia,TUN,2019,836066,992548,1828614
6120,Turkey,TUR,1990,3914553,4239808,8154361
6121,Turkey,TUR,1991,3985901,4321066,8306967
6122,Turkey,TUR,1992,4051366,4399864,8451230
6123,Turkey,TUR,1993,4113879,4478226,8592105
6124,Turkey,TUR,1994,4174604,4557604,8732208
6125,Turkey,TUR,1995,4231750,4638474,8870224
6126,Turkey,TUR,1996,4298210,4729888,9028098
6127,Turkey,TUR,1997,4376419,4840356,9216775
6128,Turkey,TUR,1998,4460036,4957671,9417707
6129,Turkey,TUR,1999,4538167,5067952,9606119
6130,Turkey,TUR,2000,4599628,5161017,9760645
6131,Turkey,TUR,2001,4652104,5252042,9904146
6132,Turkey,TUR,2002,4714530,5359820,10074350
6133,Turkey,TUR,2003,4778040,5471558,10249598
6134,Turkey,TUR,2004,4839252,5573542,10412794
6135,Turkey,TUR,2005,4886860,5649435,10536295
6136,Turkey,TUR,2006,4924483,5703415,10627898
6137,Turkey,TUR,2007,4956412,5740769,10697181
6138,Turkey,TUR,2008,4982148,5768529,10750677
6139,Turkey,TUR,2009,5004026,5796476,10800502
6140,Turkey,TUR,2010,5031664,5837802,10869466
6141,Turkey,TUR,2011,5076232,5904660,10980892
6142,Turkey,TUR,2012,5139378,5991830,11131208
6143,Turkey,TUR,2013,5223554,6096939,11320493
6144,Turkey,TUR,2014,5302852,6198112,11500964
6145,Turkey,TUR,2015,5362603,6278121,11640724
6146,Turkey,TUR,2016,5405290,6301221,11706511
6147,Turkey,TUR,2017,5433662,6301629,11735291
6148,Turkey,TUR,2018,5443659,6326537,11770196
6149,Turkey,TUR,2019,5448870,6361728,11810598
6150,Turkmenistan,TKM,1990,169760,174961,344721
6151,Turkmenistan,TKM,1991,174136,178947,353083
6152,Turkmenistan,TKM,1992,178569,182880,361449
6153,Turkmenistan,TKM,1993,183037,186622,369659
6154,Turkmenistan,TKM,1994,187545,190264,377809
6155,Turkmenistan,TKM,1995,191993,193813,385806
6156,Turkmenistan,TKM,1996,196654,197430,394084
6157,Turkmenistan,TKM,1997,201395,200908,402303
6158,Turkmenistan,TKM,1998,205889,204301,410190
6159,Turkmenistan,TKM,1999,210149,207512,417661
6160,Turkmenistan,TKM,2000,213878,210587,424465
6161,Turkmenistan,TKM,2001,217045,213332,430377
6162,Turkmenistan,TKM,2002,219575,215703,435278
6163,Turkmenistan,TKM,2003,221626,217813,439439
6164,Turkmenistan,TKM,2004,223249,219635,442884
6165,Turkmenistan,TKM,2005,224818,221419,446237
6166,Turkmenistan,TKM,2006,225811,222661,448472
6167,Turkmenistan,TKM,2007,226570,223534,450104
6168,Turkmenistan,TKM,2008,226935,224301,451236
6169,Turkmenistan,TKM,2009,227549,225226,452775
6170,Turkmenistan,TKM,2010,228569,226577,455146
6171,Turkmenistan,TKM,2011,229864,228422,458286
6172,Turkmenistan,TKM,2012,231354,230489,461843
6173,Turkmenistan,TKM,2013,232928,232690,465618
6174,Turkmenistan,TKM,2014,234635,234994,469629
6175,Turkmenistan,TKM,2015,236659,237381,474040
6176,Turkmenistan,TKM,2016,238898,239782,478680
6177,Turkmenistan,TKM,2017,241371,242260,483631
6178,Turkmenistan,TKM,2018,243898,244878,488776
6179,Turkmenistan,TKM,2019,246372,247726,494098
6180,Tuvalu,TUV,1990,489,575,1064
6181,Tuvalu,TUV,1991,490,574,1064
6182,Tuvalu,TUV,1992,491,573,1064
6183,Tuvalu,TUV,1993,493,573,1066
6184,Tuvalu,TUV,1994,495,572,1067
6185,Tuvalu,TUV,1995,498,572,1070
6186,Tuvalu,TUV,1996,502,573,1075
6187,Tuvalu,TUV,1997,505,573,1078
6188,Tuvalu,TUV,1998,509,574,1083
6189,Tuvalu,TUV,1999,514,576,1090
6190,Tuvalu,TUV,2000,519,577,1096
6191,Tuvalu,TUV,2001,524,578,1102
6192,Tuvalu,TUV,2002,531,581,1112
6193,Tuvalu,TUV,2003,538,584,1122
6194,Tuvalu,TUV,2004,546,588,1134
6195,Tuvalu,TUV,2005,554,593,1147
6196,Tuvalu,TUV,2006,564,598,1162
6197,Tuvalu,TUV,2007,574,605,1179
6198,Tuvalu,TUV,2008,585,612,1197
6199,Tuvalu,TUV,2009,596,619,1215
6200,Tuvalu,TUV,2010,607,626,1233
6201,Tuvalu,TUV,2011,619,633,1252
6202,Tuvalu,TUV,2012,630,640,1270
6203,Tuvalu,TUV,2013,641,647,1288
6204,Tuvalu,TUV,2014,652,654,1306
6205,Tuvalu,TUV,2015,662,661,1323
6206,Tuvalu,TUV,2016,671,668,1339
6207,Tuvalu,TUV,2017,678,674,1352
6208,Tuvalu,TUV,2018,687,681,1368
6209,Tuvalu,TUV,2019,697,688,1385
6210,Uganda,UGA,1990,981752,1064194,2045946
6211,Uganda,UGA,1991,1018413,1104835,2123248
6212,Uganda,UGA,1992,1057132,1147385,2204517
6213,Uganda,UGA,1993,1096414,1192500,2288914
6214,Uganda,UGA,1994,1136952,1239269,2376221
6215,Uganda,UGA,1995,1177310,1288221,2465531
6216,Uganda,UGA,1996,1218390,1341029,2559419
6217,Uganda,UGA,1997,1261255,1397222,2658477
6218,Uganda,UGA,1998,1304519,1454619,2759138
6219,Uganda,UGA,1999,1348683,1512098,2860781
6220,Uganda,UGA,2000,1392471,1565645,2958116
6221,Uganda,UGA,2001,1436979,1615704,3052683
6222,Uganda,UGA,2002,1481743,1665230,3146973
6223,Uganda,UGA,2003,1526077,1714223,3240300
6224,Uganda,UGA,2004,1570737,1762160,3332897
6225,Uganda,UGA,2005,1614764,1810506,3425270
6226,Uganda,UGA,2006,1654703,1855665,3510368
6227,Uganda,UGA,2007,1687217,1895703,3582920
6228,Uganda,UGA,2008,1717150,1933808,3650958
6229,Uganda,UGA,2009,1748121,1969744,3717865
6230,Uganda,UGA,2010,1785715,2007688,3793403
6231,Uganda,UGA,2011,1829065,2044177,3873242
6232,Uganda,UGA,2012,1876490,2076251,3952741
6233,Uganda,UGA,2013,1927414,2110371,4037785
6234,Uganda,UGA,2014,1980477,2152306,4132783
6235,Uganda,UGA,2015,2037563,2209136,4246699
6236,Uganda,UGA,2016,2097500,2280087,4377587
6237,Uganda,UGA,2017,2158691,2353952,4512643
6238,Uganda,UGA,2018,2225059,2423957,4649016
6239,Uganda,UGA,2019,2294424,2491155,4785579
6240,Ukraine,UKR,1990,2795599,3786491,6582090
6241,Ukraine,UKR,1991,2811599,3825828,6637427
6242,Ukraine,UKR,1992,2825044,3856932,6681976
6243,Ukraine,UKR,1993,2835528,3879873,6715401
6244,Ukraine,UKR,1994,2842024,3891158,6733182
6245,Ukraine,UKR,1995,2842915,3889996,6732911
6246,Ukraine,UKR,1996,2842945,3874134,6717079
6247,Ukraine,UKR,1997,2842761,3848938,6691699
6248,Ukraine,UKR,1998,2844271,3816921,6661192
6249,Ukraine,UKR,1999,2840316,3789544,6629860
6250,Ukraine,UKR,2000,2830340,3766023,6596363
6251,Ukraine,UKR,2001,2810834,3744446,6555280
6252,Ukraine,UKR,2002,2784020,3711933,6495953
6253,Ukraine,UKR,2003,2750910,3672830,6423740
6254,Ukraine,UKR,2004,2713838,3630084,6343922
6255,Ukraine,UKR,2005,2675973,3588286,6264259
6256,Ukraine,UKR,2006,2639625,3554200,6193825
6257,Ukraine,UKR,2007,2603913,3529592,6133505
6258,Ukraine,UKR,2008,2569867,3509357,6079224
6259,Ukraine,UKR,2009,2541092,3490156,6031248
6260,Ukraine,UKR,2010,2520147,3465747,5985894
6261,Ukraine,UKR,2011,2503462,3434028,5937490
6262,Ukraine,UKR,2012,2489058,3397462,5886520
6263,Ukraine,UKR,2013,2476329,3360103,5836432
6264,Ukraine,UKR,2014,2464665,3328043,5792708
6265,Ukraine,UKR,2015,2450290,3304223,5754513
6266,Ukraine,UKR,2016,2436472,3287125,5723597
6267,Ukraine,UKR,2017,2424180,3270071,5694251
6268,Ukraine,UKR,2018,2408665,3254071,5662736
6269,Ukraine,UKR,2019,2391568,3237849,5629417
6270,United Arab Emirates,ARE,1990,142910,77918,220828
6271,United Arab Emirates,ARE,1991,153139,82779,235918
6272,United Arab Emirates,ARE,1992,164265,87869,252134
6273,United Arab Emirates,ARE,1993,176254,93171,269425
6274,United Arab Emirates,ARE,1994,188795,98713,287508
6275,United Arab Emirates,ARE,1995,201609,104559,306168
6276,United Arab Emirates,ARE,1996,214458,110835,325293
6277,United Arab Emirates,ARE,1997,227533,117494,345027
6278,United Arab Emirates,ARE,1998,241160,124627,365787
6279,United Arab Emirates,ARE,1999,255631,132038,387669
6280,United Arab Emirates,ARE,2000,270837,139843,410680
6281,United Arab Emirates,ARE,2001,286911,148081,434992
6282,United Arab Emirates,ARE,2002,303789,156568,460357
6283,United Arab Emirates,ARE,2003,321350,165140,486490
6284,United Arab Emirates,ARE,2004,339025,173583,512608
6285,United Arab Emirates,ARE,2005,355888,181491,537379
6286,United Arab Emirates,ARE,2006,407209,200190,607399
6287,United Arab Emirates,ARE,2007,509441,233348,742789
6288,United Arab Emirates,ARE,2008,655446,274928,930374
6289,United Arab Emirates,ARE,2009,774613,305515,1080128
6290,United Arab Emirates,ARE,2010,797603,313814,1111417
6291,United Arab Emirates,ARE,2011,815633,321567,1137200
6292,United Arab Emirates,ARE,2012,831740,329120,1160860
6293,United Arab Emirates,ARE,2013,846275,336393,1182668
6294,United Arab Emirates,ARE,2014,858471,343303,1201774
6295,United Arab Emirates,ARE,2015,868144,349683,1217827
6296,United Arab Emirates,ARE,2016,873648,354579,1228227
6297,United Arab Emirates,ARE,2017,878210,359659,1237869
6298,United Arab Emirates,ARE,2018,883366,366008,1249374
6299,United Arab Emirates,ARE,2019,889652,373287,1262939
6300,United Kingdom,GBR,1990,3850566,4462326,8312892
6301,United Kingdom,GBR,1991,3840127,4468533,8308660
6302,United Kingdom,GBR,1992,3833323,4476057,8309380
6303,United Kingdom,GBR,1993,3831471,4485543,8317014
6304,United Kingdom,GBR,1994,3836509,4497809,8334318
6305,United Kingdom,GBR,1995,3849281,4512757,8362038
6306,United Kingdom,GBR,1996,3868866,4532314,8401180
6307,United Kingdom,GBR,1997,3892401,4556020,8448421
6308,United Kingdom,GBR,1998,3918224,4581897,8500121
6309,United Kingdom,GBR,1999,3944305,4606351,8550656
6310,United Kingdom,GBR,2000,3969649,4627089,8596738
6311,United Kingdom,GBR,2001,3989660,4639773,8629433
6312,United Kingdom,GBR,2002,4001727,4643467,8645194
6313,United Kingdom,GBR,2003,4010587,4643847,8654434
6314,United Kingdom,GBR,2004,4021887,4647458,8669345
6315,United Kingdom,GBR,2005,4041077,4661222,8702299
6316,United Kingdom,GBR,2006,4071665,4690219,8761884
6317,United Kingdom,GBR,2007,4110444,4731063,8841507
6318,United Kingdom,GBR,2008,4154313,4777654,8931967
6319,United Kingdom,GBR,2009,4199139,4824057,9023196
6320,United Kingdom,GBR,2010,4241882,4864255,9106137
6321,United Kingdom,GBR,2011,4288646,4908649,9197295
6322,United Kingdom,GBR,2012,4344167,4964486,9308653
6323,United Kingdom,GBR,2013,4401135,5022791,9423926
6324,United Kingdom,GBR,2014,4452835,5074637,9527472
6325,United Kingdom,GBR,2015,4491992,5110903,9602895
6326,United Kingdom,GBR,2016,4503687,5112986,9616673
6327,United Kingdom,GBR,2017,4513786,5113072,9626858
6328,United Kingdom,GBR,2018,4539660,5134600,9674260
6329,United Kingdom,GBR,2019,4564918,5157594,9722512
6330,United States,USA,1990,17735534,20520045,38255579
6331,United States,USA,1991,18054539,20968451,39022990
6332,United States,USA,1992,18380596,21413693,39794289
6333,United States,USA,1993,18705565,21845252,40550817
6334,United States,USA,1994,19032376,22260194,41292570
6335,United States,USA,1995,19350898,22652193,42003091
6336,United States,USA,1996,19771619,23230893,43002512
6337,United States,USA,1997,20335503,24078409,44413912
6338,United States,USA,1998,20942297,25009101,45951398
6339,United States,USA,1999,21490489,25832539,47323028
6340,United States,USA,2000,21860305,26345640,48205945
6341,United States,USA,2001,22055564,26546785,48602349
6342,United States,USA,2002,22163380,26604029,48767409
6343,United States,USA,2003,22227183,26582576,48809759
6344,United States,USA,2004,22298179,26566680,48864859
6345,United States,USA,2005,22411446,26614644,49026090
6346,United States,USA,2006,22595757,26733110,49328867
6347,United States,USA,2007,22820930,26856424,49677354
6348,United States,USA,2008,23058367,26976677,50035044
6349,United States,USA,2009,23274633,27088645,50363278
6350,United States,USA,2010,23428984,27173128,50602112
6351,United States,USA,2011,23472755,27172867,50645622
6352,United States,USA,2012,23411492,27060813,50472305
6353,United States,USA,2013,23312147,26919399,50231546
6354,United States,USA,2014,23244131,26823690,50067821
6355,United States,USA,2015,23270211,26847967,50118178
6356,United States,USA,2016,23464920,26944373,50409293
6357,United States,USA,2017,23673258,27067137,50740395
6358,United States,USA,2018,23963326,27581091,51544417
6359,United States,USA,2019,24454357,28517494,52971851
6360,United States Virgin Islands,VIR,1990,6994,7522,14516
6361,United States Virgin Islands,VIR,1991,7010,7543,14553
6362,United States Virgin Islands,VIR,1992,7032,7580,14612
6363,United States Virgin Islands,VIR,1993,7054,7628,14682
6364,United States Virgin Islands,VIR,1994,7077,7688,14765
6365,United States Virgin Islands,VIR,1995,7102,7757,14859
6366,United States Virgin Islands,VIR,1996,7128,7836,14964
6367,United States Virgin Islands,VIR,1997,7152,7915,15067
6368,United States Virgin Islands,VIR,1998,7173,7998,15171
6369,United States Virgin Islands,VIR,1999,7189,8069,15258
6370,United States Virgin Islands,VIR,2000,7201,8123,15324
6371,United States Virgin Islands,VIR,2001,7212,8159,15371
6372,United States Virgin Islands,VIR,2002,7221,8177,15398
6373,United States Virgin Islands,VIR,2003,7227,8187,15414
6374,United States Virgin Islands,VIR,2004,7228,8187,15415
6375,United States Virgin Islands,VIR,2005,7224,8181,15405
6376,United States Virgin Islands,VIR,2006,7212,8167,15379
6377,United States Virgin Islands,VIR,2007,7189,8152,15341
6378,United States Virgin Islands,VIR,2008,7162,8133,15295
6379,United States Virgin Islands,VIR,2009,7131,8113,15244
6380,United States Virgin Islands,VIR,2010,7098,8094,15192
6381,United States Virgin Islands,VIR,2011,7072,8084,15156
6382,United States Virgin Islands,VIR,2012,7047,8080,15127
6383,United States Virgin Islands,VIR,2013,7023,8079,15102
6384,United States Virgin Islands,VIR,2014,6997,8074,15071
6385,United States Virgin Islands,VIR,2015,6961,8066,15027
6386,United States Virgin Islands,VIR,2016,6909,8050,14959
6387,United States Virgin Islands,VIR,2017,6856,8030,14886
6388,United States Virgin Islands,VIR,2018,6820,8025,14845
6389,United States Virgin Islands,VIR,2019,6796,8037,14833
6390,Uruguay,URY,1990,176474,230595,407069
6391,Uruguay,URY,1991,177268,231675,408943
6392,Uruguay,URY,1992,178047,232857,410904
6393,Uruguay,URY,1993,178827,233964,412791
6394,Uruguay,URY,1994,179589,235264,414853
6395,Uruguay,URY,1995,180435,236566,417001
6396,Uruguay,URY,1996,181161,237945,419106
6397,Uruguay,URY,1997,181856,239391,421247
6398,Uruguay,URY,1998,182626,240778,423404
6399,Uruguay,URY,1999,183380,242302,425682
6400,Uruguay,URY,2000,184307,243831,428138
6401,Uruguay,URY,2001,185366,245496,430862
6402,Uruguay,URY,2002,186619,247407,434026
6403,Uruguay,URY,2003,187894,249276,437170
6404,Uruguay,URY,2004,189046,251076,440122
6405,Uruguay,URY,2005,189857,252551,442408
6406,Uruguay,URY,2006,190407,253736,444143
6407,Uruguay,URY,2007,190868,254844,445712
6408,Uruguay,URY,2008,191206,255857,447063
6409,Uruguay,URY,2009,191657,256938,448595
6410,Uruguay,URY,2010,192104,258128,450232
6411,Uruguay,URY,2011,192626,259729,452355
6412,Uruguay,URY,2012,193363,261647,455010
6413,Uruguay,URY,2013,194071,263712,457783
6414,Uruguay,URY,2014,194826,265601,460427
6415,Uruguay,URY,2015,195200,266916,462116
6416,Uruguay,URY,2016,195097,267504,462601
6417,Uruguay,URY,2017,195084,268074,463158
6418,Uruguay,URY,2018,195386,268769,464155
6419,Uruguay,URY,2019,195835,269487,465322
6420,Uzbekistan,UZB,1990,990031,995401,1985432
6421,Uzbekistan,UZB,1991,1017712,1021554,2039266
6422,Uzbekistan,UZB,1992,1045968,1048241,2094209
6423,Uzbekistan,UZB,1993,1074327,1074625,2148952
6424,Uzbekistan,UZB,1994,1102300,1100494,2202794
6425,Uzbekistan,UZB,1995,1130817,1126298,2257115
6426,Uzbekistan,UZB,1996,1159681,1152482,2312163
6427,Uzbekistan,UZB,1997,1188645,1178334,2366979
6428,Uzbekistan,UZB,1998,1218106,1203719,2421825
6429,Uzbekistan,UZB,1999,1246245,1229351,2475596
6430,Uzbekistan,UZB,2000,1272950,1254984,2527934
6431,Uzbekistan,UZB,2001,1297053,1279433,2576486
6432,Uzbekistan,UZB,2002,1319476,1303752,2623228
6433,Uzbekistan,UZB,2003,1340774,1325779,2666553
6434,Uzbekistan,UZB,2004,1360962,1347658,2708620
6435,Uzbekistan,UZB,2005,1379859,1369342,2749201
6436,Uzbekistan,UZB,2006,1397776,1390047,2787823
6437,Uzbekistan,UZB,2007,1412971,1409164,2822135
6438,Uzbekistan,UZB,2008,1427404,1426908,2854312
6439,Uzbekistan,UZB,2009,1442245,1444759,2887004
6440,Uzbekistan,UZB,2010,1458741,1464770,2923511
6441,Uzbekistan,UZB,2011,1476068,1485292,2961360
6442,Uzbekistan,UZB,2012,1493436,1505782,2999218
6443,Uzbekistan,UZB,2013,1512132,1526081,3038213
6444,Uzbekistan,UZB,2014,1530896,1548445,3079341
6445,Uzbekistan,UZB,2015,1550197,1571576,3121773
6446,Uzbekistan,UZB,2016,1568583,1594226,3162809
6447,Uzbekistan,UZB,2017,1588513,1619075,3207588
6448,Uzbekistan,UZB,2018,1611999,1643691,3255690
6449,Uzbekistan,UZB,2019,1637967,1669376,3307343
6450,Vanuatu,VUT,1990,8187,7778,15965
6451,Vanuatu,VUT,1991,8382,7988,16370
6452,Vanuatu,VUT,1992,8588,8199,16787
6453,Vanuatu,VUT,1993,8799,8411,17210
6454,Vanuatu,VUT,1994,9018,8637,17655
6455,Vanuatu,VUT,1995,9244,8865,18109
6456,Vanuatu,VUT,1996,9479,9102,18581
6457,Vanuatu,VUT,1997,9719,9346,19065
6458,Vanuatu,VUT,1998,9962,9596,19558
6459,Vanuatu,VUT,1999,10217,9863,20080
6460,Vanuatu,VUT,2000,10488,10144,20632
6461,Vanuatu,VUT,2001,10773,10439,21212
6462,Vanuatu,VUT,2002,11069,10743,21812
6463,Vanuatu,VUT,2003,11364,11056,22420
6464,Vanuatu,VUT,2004,11669,11380,23049
6465,Vanuatu,VUT,2005,11977,11710,23687
6466,Vanuatu,VUT,2006,12292,12046,24338
6467,Vanuatu,VUT,2007,12593,12373,24966
6468,Vanuatu,VUT,2008,12898,12701,25599
6469,Vanuatu,VUT,2009,13196,13026,26222
6470,Vanuatu,VUT,2010,13498,13349,26847
6471,Vanuatu,VUT,2011,13802,13667,27469
6472,Vanuatu,VUT,2012,14110,13990,28100
6473,Vanuatu,VUT,2013,14418,14308,28726
6474,Vanuatu,VUT,2014,14730,14632,29362
6475,Vanuatu,VUT,2015,15043,14956,29999
6476,Vanuatu,VUT,2016,15338,15276,30614
6477,Vanuatu,VUT,2017,15632,15596,31228
6478,Vanuatu,VUT,2018,15962,15957,31919
6479,Vanuatu,VUT,2019,16308,16336,32644
6480,Venezuela,VEN,1990,1160569,1141204,2301773
6481,Venezuela,VEN,1991,1190578,1175509,2366087
6482,Venezuela,VEN,1992,1221004,1209529,2430533
6483,Venezuela,VEN,1993,1251149,1244914,2496063
6484,Venezuela,VEN,1994,1281831,1279710,2561541
6485,Venezuela,VEN,1995,1312050,1314292,2626342
6486,Venezuela,VEN,1996,1342716,1349169,2691885
6487,Venezuela,VEN,1997,1374642,1382966,2757608
6488,Venezuela,VEN,1998,1406902,1418076,2824978
6489,Venezuela,VEN,1999,1438097,1451462,2889559
6490,Venezuela,VEN,2000,1469577,1485357,2954934
6491,Venezuela,VEN,2001,1502966,1519889,3022855
6492,Venezuela,VEN,2002,1536692,1554215,3090907
6493,Venezuela,VEN,2003,1570641,1589684,3160325
6494,Venezuela,VEN,2004,1604284,1624251,3228535
6495,Venezuela,VEN,2005,1637841,1658738,3296579
6496,Venezuela,VEN,2006,1670842,1692010,3362852
6497,Venezuela,VEN,2007,1702433,1725080,3427513
6498,Venezuela,VEN,2008,1733747,1757446,3491193
6499,Venezuela,VEN,2009,1765215,1789839,3555054
6500,Venezuela,VEN,2010,1796509,1823576,3620085
6501,Venezuela,VEN,2011,1827364,1858899,3686263
6502,Venezuela,VEN,2012,1856275,1893356,3749631
6503,Venezuela,VEN,2013,1886121,1928849,3814970
6504,Venezuela,VEN,2014,1915238,1963904,3879142
6505,Venezuela,VEN,2015,1934994,1990201,3925195
6506,Venezuela,VEN,2016,1892121,1970150,3862271
6507,Venezuela,VEN,2017,1804910,1916621,3721531
6508,Venezuela,VEN,2018,1782052,1907128,3689180
6509,Venezuela,VEN,2019,1807408,1931956,3739364
6510,Vietnam,VNM,1990,2773294,3783759,6557053
6511,Vietnam,VNM,1991,2831156,3843116,6674272
6512,Vietnam,VNM,1992,2889186,3901430,6790616
6513,Vietnam,VNM,1993,2950885,3960680,6911565
6514,Vietnam,VNM,1994,3013094,4020779,7033873
6515,Vietnam,VNM,1995,3076242,4080825,7157067
6516,Vietnam,VNM,1996,3138874,4139799,7278673
6517,Vietnam,VNM,1997,3200117,4200741,7400858
6518,Vietnam,VNM,1998,3259117,4260086,7519203
6519,Vietnam,VNM,1999,3314184,4316910,7631094
6520,Vietnam,VNM,2000,3367835,4369139,7736974
6521,Vietnam,VNM,2001,3412120,4407184,7819304
6522,Vietnam,VNM,2002,3445952,4427194,7873146
6523,Vietnam,VNM,2003,3472849,4441528,7914377
6524,Vietnam,VNM,2004,3497886,4454760,7952646
6525,Vietnam,VNM,2005,3529555,4483665,8013220
6526,Vietnam,VNM,2006,3568589,4521013,8089602
6527,Vietnam,VNM,2007,3602645,4552850,8155495
6528,Vietnam,VNM,2008,3636789,4585191,8221980
6529,Vietnam,VNM,2009,3668876,4616379,8285255
6530,Vietnam,VNM,2010,3702654,4648132,8350786
6531,Vietnam,VNM,2011,3743961,4693928,8437889
6532,Vietnam,VNM,2012,3802153,4757712,8559865
6533,Vietnam,VNM,2013,3864592,4829901,8694493
6534,Vietnam,VNM,2014,3923752,4895864,8819616
6535,Vietnam,VNM,2015,3972473,4946576,8919049
6536,Vietnam,VNM,2016,4009621,4982496,8992117
6537,Vietnam,VNM,2017,4047423,5017567,9064990
6538,Vietnam,VNM,2018,4084500,5056856,9141356
6539,Vietnam,VNM,2019,4123304,5098734,9222038
6540,Wales,,1990,185596,227282,412878
6541,Wales,,1991,185415,226470,411885
6542,Wales,,1992,185271,225700,410971
6543,Wales,,1993,185188,225174,410362
6544,Wales,,1994,185269,224926,410195
6545,Wales,,1995,185500,224912,410412
6546,Wales,,1996,185845,225145,410990
6547,Wales,,1997,186346,225345,411691
6548,Wales,,1998,186932,225756,412688
6549,Wales,,1999,187622,226052,413674
6550,Wales,,2000,188359,226257,414616
6551,Wales,,2001,188976,226186,415162
6552,Wales,,2002,189438,225685,415123
6553,Wales,,2003,189781,225090,414871
6554,Wales,,2004,190285,224771,415056
6555,Wales,,2005,191067,225022,416089
6556,Wales,,2006,191929,225776,417705
6557,Wales,,2007,192730,226646,419376
6558,Wales,,2008,193585,227615,421200
6559,Wales,,2009,194395,228557,422952
6560,Wales,,2010,195457,229546,425003
6561,Wales,,2011,196727,230650,427377
6562,Wales,,2012,198073,232124,430197
6563,Wales,,2013,199466,233559,433025
6564,Wales,,2014,200773,234872,435645
6565,Wales,,2015,201896,235778,437674
6566,Wales,,2016,202735,236000,438735
6567,Wales,,2017,203428,236076,439504
6568,Wales,,2018,204268,236795,441063
6569,Wales,,2019,205014,237923,442937
6570,Western Pacific Region (WHO),,1990,87692942,86331228,174024170
6571,Western Pacific Region (WHO),,1991,89735879,87722923,177458802
6572,Western Pacific Region (WHO),,1992,91645768,89054457,180700225
6573,Western Pacific Region (WHO),,1993,93392547,90352067,183744614
6574,Western Pacific Region (WHO),,1994,94922636,91623844,186546480
6575,Western Pacific Region (WHO),,1995,96201007,92879298,189080305
6576,Western Pacific Region (WHO),,1996,97175357,94244923,191420280
6577,Western Pacific Region (WHO),,1997,97886743,95797281,193684024
6578,Western Pacific Region (WHO),,1998,98441044,97408459,195849503
6579,Western Pacific Region (WHO),,1999,98927061,98950801,197877862
6580,Western Pacific Region (WHO),,2000,99432953,100255616,199688569
6581,Western Pacific Region (WHO),,2001,99864987,101118992,200983979
6582,Western Pacific Region (WHO),,2002,100097040,101533055,201630095
6583,Western Pacific Region (WHO),,2003,100224874,101696122,201920996
6584,Western Pacific Region (WHO),,2004,100331268,101857892,202189160
6585,Western Pacific Region (WHO),,2005,100517872,102281712,202799584
6586,Western Pacific Region (WHO),,2006,100792809,102826864,203619673
6587,Western Pacific Region (WHO),,2007,101054494,103241445,204295939
6588,Western Pacific Region (WHO),,2008,101309061,103604369,204913430
6589,Western Pacific Region (WHO),,2009,101548056,104010873,205558929
6590,Western Pacific Region (WHO),,2010,101792952,104534278,206327230
6591,Western Pacific Region (WHO),,2011,102000359,105061085,207061444
6592,Western Pacific Region (WHO),,2012,102168612,105477885,207646497
6593,Western Pacific Region (WHO),,2013,102352451,105892946,208245397
6594,Western Pacific Region (WHO),,2014,102611558,106390107,209001665
6595,Western Pacific Region (WHO),,2015,103027282,107069303,210096585
6596,Western Pacific Region (WHO),,2016,103883224,108276261,212159485
6597,Western Pacific Region (WHO),,2017,104803516,109503854,214307370
6598,Western Pacific Region (WHO),,2018,105286217,110159665,215445882
6599,Western Pacific Region (WHO),,2019,105482452,110446525,215928977
6600,World,OWID_WRL,1990,317782882,337040834,654823716
6601,World,OWID_WRL,1991,324241954,343597296,667839250
6602,World,OWID_WRL,1992,330564313,350078664,680642977
6603,World,OWID_WRL,1993,336711739,356440861,693152600
6604,World,OWID_WRL,1994,342592971,362713799,705306770
6605,World,OWID_WRL,1995,348162403,368851250,717013653
6606,World,OWID_WRL,1996,353519356,375327104,728846460
6607,World,OWID_WRL,1997,358710310,382411261,741121571
6608,World,OWID_WRL,1998,363730029,389715753,753445782
6609,World,OWID_WRL,1999,368652023,396929938,765581961
6610,World,OWID_WRL,2000,373541087,403722043,777263130
6611,World,OWID_WRL,2001,378404716,410000632,788405348
6612,World,OWID_WRL,2002,383189996,415932158,799122154
6613,World,OWID_WRL,2003,387877926,421635635,809513561
6614,World,OWID_WRL,2004,392499493,427288798,819788291
6615,World,OWID_WRL,2005,397080313,433037639,830117952
6616,World,OWID_WRL,2006,401561625,438451678,840013303
6617,World,OWID_WRL,2007,405903241,443253775,849157016
6618,World,OWID_WRL,2008,410053426,447685387,857738813
6619,World,OWID_WRL,2009,414084894,452166733,866251627
6620,World,OWID_WRL,2010,418351127,457277902,875629029
6621,World,OWID_WRL,2011,422845330,462648453,885493783
6622,World,OWID_WRL,2012,427302600,467648360,894950960
6623,World,OWID_WRL,2013,431766835,472567415,904334250
6624,World,OWID_WRL,2014,436320330,477677730,913998060
6625,World,OWID_WRL,2015,441135027,483309460,924444487
6626,World,OWID_WRL,2016,446576532,489713214,936289746
6627,World,OWID_WRL,2017,452115391,496202954,948318345
6628,World,OWID_WRL,2018,457222519,502215753,959438272
6629,World,OWID_WRL,2019,462168672,507901572,970070244
6630,World Bank High Income,,1990,63949137,75418146,139367283
6631,World Bank High Income,,1991,64404296,76115909,140520205
6632,World Bank High Income,,1992,64864498,76821731,141686229
6633,World Bank High Income,,1993,65324155,77512365,142836520
6634,World Bank High Income,,1994,65786170,78188349,143974519
6635,World Bank High Income,,1995,66260125,78853710,145113835
6636,World Bank High Income,,1996,66853831,79741742,146595573
6637,World Bank High Income,,1997,67597654,80938681,148536335
6638,World Bank High Income,,1998,68390996,82241201,150632197
6639,World Bank High Income,,1999,69137130,83434769,152571899
6640,World Bank High Income,,2000,69743603,84307296,154050899
6641,World Bank High Income,,2001,70223580,84836377,155059957
6642,World Bank High Income,,2002,70634243,85184455,155818698
6643,World Bank High Income,,2003,71000332,85445759,156446091
6644,World Bank High Income,,2004,71391716,85743297,157135013
6645,World Bank High Income,,2005,71831175,86162146,157993321
6646,World Bank High Income,,2006,72427952,86772310,159200262
6647,World Bank High Income,,2007,73179779,87507647,160687426
6648,World Bank High Income,,2008,74016584,88284739,162301323
6649,World Bank High Income,,2009,74773827,88999739,163773566
6650,World Bank High Income,,2010,75324606,89548532,164873138
6651,World Bank High Income,,2011,75733168,89904576,165637744
6652,World Bank High Income,,2012,76050533,90105828,166156361
6653,World Bank High Income,,2013,76293544,90244228,166537772
6654,World Bank High Income,,2014,76550362,90417350,166967712
6655,World Bank High Income,,2015,76890544,90713631,167604175
6656,World Bank High Income,,2016,77378178,90943347,168321525
6657,World Bank High Income,,2017,77857095,91185043,169042138
6658,World Bank High Income,,2018,78418733,91866193,170284926
6659,World Bank High Income,,2019,79193601,92888655,172082256
6660,World Bank Low Income,,1990,17422062,18788046,36210108
6661,World Bank Low Income,,1991,17986472,19341881,37328353
6662,World Bank Low Income,,1992,18608783,19929263,38538046
6663,World Bank Low Income,,1993,19212374,20494518,39706892
6664,World Bank Low Income,,1994,19816592,21096237,40912829
6665,World Bank Low Income,,1995,20452008,21746502,42198510
6666,World Bank Low Income,,1996,21115269,22425156,43540425
6667,World Bank Low Income,,1997,21776461,23105115,44881576
6668,World Bank Low Income,,1998,22392449,23744091,46136540
6669,World Bank Low Income,,1999,22983004,24366815,47349819
6670,World Bank Low Income,,2000,23587233,24998704,48585937
6671,World Bank Low Income,,2001,24249222,25656858,49906080
6672,World Bank Low Income,,2002,24968618,26345586,51314204
6673,World Bank Low Income,,2003,25668968,27020389,52689357
6674,World Bank Low Income,,2004,26372041,27704421,54076462
6675,World Bank Low Income,,2005,27081783,28416450,55498233
6676,World Bank Low Income,,2006,27761389,29129165,56890554
6677,World Bank Low Income,,2007,28452360,29859129,58311489
6678,World Bank Low Income,,2008,29160625,30613410,59774035
6679,World Bank Low Income,,2009,29885339,31388952,61274291
6680,World Bank Low Income,,2010,30639031,32205525,62844556
6681,World Bank Low Income,,2011,31420602,33048853,64469455
6682,World Bank Low Income,,2012,32224554,33917268,66141822
6683,World Bank Low Income,,2013,33037862,34795543,67833405
6684,World Bank Low Income,,2014,33839128,35688865,69527993
6685,World Bank Low Income,,2015,34665207,36617189,71282396
6686,World Bank Low Income,,2016,35541725,37630451,73172176
6687,World Bank Low Income,,2017,36492548,38705886,75198434
6688,World Bank Low Income,,2018,37512783,39798002,77310785
6689,World Bank Low Income,,2019,38590391,40898262,79488653
6690,World Bank Lower Middle Income,,1990,114980094,117200377,232180471
6691,World Bank Lower Middle Income,,1991,117690496,120206105,237896601
6692,World Bank Lower Middle Income,,1992,120371641,123183799,243555440
6693,World Bank Lower Middle Income,,1993,123031264,126094989,249126253
6694,World Bank Lower Middle Income,,1994,125631317,128921633,254552950
6695,World Bank Lower Middle Income,,1995,128152510,131611320,259763830
6696,World Bank Lower Middle Income,,1996,130490406,134128501,264618907
6697,World Bank Lower Middle Income,,1997,132600708,136521814,269122522
6698,World Bank Lower Middle Income,,1998,134627213,138886851,273514064
6699,World Bank Lower Middle Income,,1999,136750779,141361531,278112310
6700,World Bank Lower Middle Income,,2000,139144096,144084015,283228111
6701,World Bank Lower Middle Income,,2001,141817849,147099661,288917510
6702,World Bank Lower Middle Income,,2002,144641440,150289450,294930890
6703,World Bank Lower Middle Income,,2003,147559241,153609699,301168940
6704,World Bank Lower Middle Income,,2004,150480289,156987291,307467580
6705,World Bank Lower Middle Income,,2005,153340066,160324705,313664771
6706,World Bank Lower Middle Income,,2006,155895179,163219235,319114414
6707,World Bank Lower Middle Income,,2007,158129501,165559908,323689409
6708,World Bank Lower Middle Income,,2008,160227868,167663270,327891138
6709,World Bank Lower Middle Income,,2009,162409695,169888196,332297891
6710,World Bank Lower Middle Income,,2010,164863911,172576456,337440367
6711,World Bank Lower Middle Income,,2011,167536254,175651391,343187645
6712,World Bank Lower Middle Income,,2012,170248715,178783546,349032261
6713,World Bank Lower Middle Income,,2013,173004256,181979214,354983470
6714,World Bank Lower Middle Income,,2014,175794923,185217798,361012721
6715,World Bank Lower Middle Income,,2015,178587140,188462496,367049636
6716,World Bank Lower Middle Income,,2016,181353324,191694068,373047392
6717,World Bank Lower Middle Income,,2017,184118565,194945115,379063680
6718,World Bank Lower Middle Income,,2018,186793700,197954506,384748206
6719,World Bank Lower Middle Income,,2019,189368743,200658437,390027180
6720,World Bank Upper Middle Income,,1990,121251095,125438813,246689908
6721,World Bank Upper Middle Income,,1991,123976902,127734196,251711098
6722,World Bank Upper Middle Income,,1992,126532446,129941166,256473612
6723,World Bank Upper Middle Income,,1993,128953878,132132922,261086800
6724,World Bank Upper Middle Income,,1994,131165617,134298036,265463653
6725,World Bank Upper Middle Income,,1995,133100999,136426410,269527409
6726,World Bank Upper Middle Income,,1996,134859346,138814357,273673703
6727,World Bank Upper Middle Income,,1997,136531078,141624030,278155108
6728,World Bank Upper Middle Income,,1998,138110888,144617515,282728403
6729,World Bank Upper Middle Income,,1999,139568326,147536070,287104396
6730,World Bank Upper Middle Income,,2000,140848818,150096444,290945262
6731,World Bank Upper Middle Income,,2001,141891873,152167163,294059036
6732,World Bank Upper Middle Income,,2002,142718385,153866936,296585321
6733,World Bank Upper Middle Income,,2003,143416955,155308904,298725859
6734,World Bank Upper Middle Income,,2004,144018181,156597939,300616120
6735,World Bank Upper Middle Income,,2005,144585651,157873894,302459545
6736,World Bank Upper Middle Income,,2006,145231406,159066280,304297686
6737,World Bank Upper Middle Income,,2007,145892064,160058415,305950479
6738,World Bank Upper Middle Income,,2008,146395459,160851717,307247176
6739,World Bank Upper Middle Income,,2009,146760303,161614428,308374731
6740,World Bank Upper Middle Income,,2010,147265620,162669179,309934799
6741,World Bank Upper Middle Income,,2011,147895175,163762770,311657945
6742,World Bank Upper Middle Income,,2012,148516225,164558082,313074307
6743,World Bank Upper Middle Income,,2013,149166168,165262059,314428227
6744,World Bank Upper Middle Income,,2014,149868408,166064480,315932888
6745,World Bank Upper Middle Income,,2015,150721927,167223778,317945705
6746,World Bank Upper Middle Income,,2016,152030305,169149481,321179786
6747,World Bank Upper Middle Income,,2017,153371174,171067272,324438446
6748,World Bank Upper Middle Income,,2018,154217635,172293230,326510865
6749,World Bank Upper Middle Income,,2019,154732206,173148029,327880235
6750,Yemen,YEM,1990,933191,965357,1898548
6751,Yemen,YEM,1991,968614,999657,1968271
6752,Yemen,YEM,1992,1004573,1035170,2039743
6753,Yemen,YEM,1993,1040642,1070805,2111447
6754,Yemen,YEM,1994,1076533,1108555,2185088
6755,Yemen,YEM,1995,1112568,1146433,2259001
6756,Yemen,YEM,1996,1149791,1185007,2334798
6757,Yemen,YEM,1997,1186225,1224760,2410985
6758,Yemen,YEM,1998,1222451,1264800,2487251
6759,Yemen,YEM,1999,1258821,1305822,2564643
6760,Yemen,YEM,2000,1294155,1347807,2641962
6761,Yemen,YEM,2001,1329456,1390977,2720433
6762,Yemen,YEM,2002,1364733,1434372,2799105
6763,Yemen,YEM,2003,1400778,1479252,2880030
6764,Yemen,YEM,2004,1437103,1524219,2961322
6765,Yemen,YEM,2005,1475447,1571172,3046619
6766,Yemen,YEM,2006,1513517,1617632,3131149
6767,Yemen,YEM,2007,1550268,1665178,3215446
6768,Yemen,YEM,2008,1589677,1713662,3303339
6769,Yemen,YEM,2009,1631966,1764810,3396776
6770,Yemen,YEM,2010,1679884,1820841,3500725
6771,Yemen,YEM,2011,1733094,1879976,3613070
6772,Yemen,YEM,2012,1789112,1940658,3729770
6773,Yemen,YEM,2013,1848912,2004302,3853214
6774,Yemen,YEM,2014,1910344,2070153,3980497
6775,Yemen,YEM,2015,1973328,2138326,4111654
6776,Yemen,YEM,2016,2046716,2213924,4260640
6777,Yemen,YEM,2017,2128796,2299536,4428332
6778,Yemen,YEM,2018,2210895,2388145,4599040
6779,Yemen,YEM,2019,2299051,2484232,4783283
6780,Zambia,ZMB,1990,374323,404023,778346
6781,Zambia,ZMB,1991,384772,413995,798767
6782,Zambia,ZMB,1992,394807,423552,818359
6783,Zambia,ZMB,1993,404462,432918,837380
6784,Zambia,ZMB,1994,413738,442081,855819
6785,Zambia,ZMB,1995,423001,451123,874124
6786,Zambia,ZMB,1996,432360,460511,892871
6787,Zambia,ZMB,1997,442210,470361,912571
6788,Zambia,ZMB,1998,452694,480764,933458
6789,Zambia,ZMB,1999,463897,491798,955695
6790,Zambia,ZMB,2000,475806,503658,979464
6791,Zambia,ZMB,2001,489251,516605,1005856
6792,Zambia,ZMB,2002,504161,530420,1034581
6793,Zambia,ZMB,2003,520497,545391,1065888
6794,Zambia,ZMB,2004,538053,561899,1099952
6795,Zambia,ZMB,2005,556393,579865,1136258
6796,Zambia,ZMB,2006,575027,598899,1173926
6797,Zambia,ZMB,2007,593986,619061,1213047
6798,Zambia,ZMB,2008,613675,640801,1254476
6799,Zambia,ZMB,2009,634877,663598,1298475
6800,Zambia,ZMB,2010,657103,688293,1345396
6801,Zambia,ZMB,2011,681298,714318,1395616
6802,Zambia,ZMB,2012,707278,742187,1449465
6803,Zambia,ZMB,2013,734791,771929,1506720
6804,Zambia,ZMB,2014,763184,802906,1566090
6805,Zambia,ZMB,2015,792157,834430,1626587
6806,Zambia,ZMB,2016,821325,867621,1688946
6807,Zambia,ZMB,2017,851054,900241,1751295
6808,Zambia,ZMB,2018,881482,933151,1814633
6809,Zambia,ZMB,2019,912276,965740,1878016
6810,Zimbabwe,ZWE,1990,462022,453505,915527
6811,Zimbabwe,ZWE,1991,475786,468079,943865
6812,Zimbabwe,ZWE,1992,488397,481663,970060
6813,Zimbabwe,ZWE,1993,499879,494332,994211
6814,Zimbabwe,ZWE,1994,510011,505822,1015833
6815,Zimbabwe,ZWE,1995,518837,516543,1035380
6816,Zimbabwe,ZWE,1996,525968,526064,1052032
6817,Zimbabwe,ZWE,1997,531862,534202,1066064
6818,Zimbabwe,ZWE,1998,536465,540972,1077437
6819,Zimbabwe,ZWE,1999,540270,546810,1087080
6820,Zimbabwe,ZWE,2000,543939,552398,1096337
6821,Zimbabwe,ZWE,2001,547695,558460,1106155
6822,Zimbabwe,ZWE,2002,552376,564469,1116845
6823,Zimbabwe,ZWE,2003,557594,571305,1128899
6824,Zimbabwe,ZWE,2004,563498,577998,1141496
6825,Zimbabwe,ZWE,2005,569614,584851,1154465
6826,Zimbabwe,ZWE,2006,576607,592168,1168775
6827,Zimbabwe,ZWE,2007,585136,600289,1185425
6828,Zimbabwe,ZWE,2008,594296,609283,1203579
6829,Zimbabwe,ZWE,2009,603670,618614,1222284
6830,Zimbabwe,ZWE,2010,612333,627970,1240303
6831,Zimbabwe,ZWE,2011,620764,638460,1259224
6832,Zimbabwe,ZWE,2012,629685,650789,1280474
6833,Zimbabwe,ZWE,2013,639292,663894,1303186
6834,Zimbabwe,ZWE,2014,649542,677564,1327106
6835,Zimbabwe,ZWE,2015,660281,690807,1351088
6836,Zimbabwe,ZWE,2016,670288,704447,1374735
6837,Zimbabwe,ZWE,2017,681112,718234,1399346
6838,Zimbabwe,ZWE,2018,692885,731496,1424381
6839,Zimbabwe,ZWE,2019,704704,742880,1447584
